oreb	'ɑ.ɹɛ
didst	'dɪds
sion	sɪ.'ɑ
siloa's	saɪ.'ləʊ.ʌ
aonian	eɪ.'ɑ.neɪ.ʌ
unattempted	ʌ.næ.'tɛmp.tɪ
know'st	'nəʊs
wast	'wɑs
outspread	aʊt.'spɹɛ
sat'st	'sæts
mad'st	'mæds
illumine	ɪ.'lʉː.maɪ
favoured	'feɪ.vʌ
equalled	'i.kwʌl
impious	ɪm.pɪ.'ʌ
perdition	pəː.'dɪ.ʃʌ
adamantine	'æ.dæ.`mɑn.ti
obdurate	'ɑbd.jʊə.ɹʌ
unconsumed	ʌn.kʌn.'sʉːm
o'erwhelmed	'ɔː.wɛlm
whirlwinds	'wəːl.wɪnd
discerns	dɪ.'səːn
weltering	'wɛl.tʌ.ɹɪŋ
beelzebub	'bil.zɪ.`bʌ
beest	'bis
myriads	'mɪ.ɹɪ.`æd
seest	'sis
unconquerable	ʌn.'kɑn.kʌ.ɹʌ.bʌ
suppliant	sʌ.'plaɪ.ʌn
empyreal	ɛm.'pɪ.ɹeɪ.ʌ
apostate	æ.'pɑ.steɪ
vaunting	'vɔːn.tɪŋ
compeer	kʌm.'peɪ.ʌ.ʌ
throned	'θɹəʊn
seraphim	'sɛ.ɹʌ.fɪ
essences	'ɛ.sʌn.sɪ
vigour	'vɪ.ɡʌ
o'erpowered	'ɔː.paʊ.ʌ
thralls	'θɹɔːl
whate'er	'wɑ.təː
whereto	'wəː.təʊ
aught	'ɔː
ofttimes	'ɑft.taɪm
inmost	'ɪn.məʊs
sulphurous	'sʌl.fʌ.ɹʌ
o'erblown	'ɔː.bləʊ
satiate	'seɪ.ʃɪ.`eɪ
thither	'ðɪ.ðʌ
titanian	tɪ.'tɑ.neɪ.ʌ
warred	'wɔː
jove	'dʒəʊ
briareos	'bɹaɪ.ʌ.ɹɪ.`əʊ
typhon	'taɪ.fɑ
haply	'hæ.pli
deeming	'di.mɪŋ
scaly	'skeɪ.lɪ
morn	'mɔː
shewn	'ʃjʉː
dusky	'dʌ.ski
pelorus	'pɛ.lɔː.ɹʌ
combustible	kʌm.'bʌ.stʌ.bʌ
sublimed	sʌ.'blaɪm
unblest	ʌn.'blɛs
glorying	'ɡlɔː.ɹɪ.ɪŋ
scaped	'skeɪp
stygian	'stɪ.dʒeɪ.ʌ
sufferance	'sʌ.fʌ.ɹʌn
supernal	sʉː.'pəː.nʌ
clime	'klaɪ
profoundest	pɹʌ.'faʊn.dʌs
wherefore	'wəː.fɔː
grovelling	'ɡɹɑ.vʌ.lɪŋ
erewhile	ɪ.'ɹʉː.haɪ
massy	'mæ.si
fesole	'fɛ.səʊ
valdarno	væl.'dɑ.nəʊ
descry	dɪ.'skɹeɪ
ammiral	'æ.məː.ɹʌ
marl	'mɑ
smote	'sməʊ
nathless	'næθ.lʌ
vallombrosa	`væ.lʌm.'bɹəʊ.sʌ
etrurian	ɪ.'tɹʊə.ɹeɪ.ʌ
embower	ɛm.'baʊ.ʌ
o'erthrew	'ɔː.θɹʉː
busiris	'bjʉː.sɪ.`ɹɪ
memphian	'mɛm.feɪ.ʌ
perfidious	pəː.'fɪ.dɪ.ʌ
sojourners	'sɑ.dʒəː.nʌ
beheld	bɪ.'hɛl
carcases	'kɑ.keɪ.sɪ
bestrown	bɪ.'stɹəʊ
resounded	ɹɪ.'zaʊn.dɪ
beholds	bɪ.'həʊld
seraph	'sɛ.ɹʌ
ensigns	'ɛn.saɪn
anon	æ.'nɑ
thunderbolts	'θʌn.dʌ.`bəʊlt
bestir	bɪ.'stəː
amram's	'æm.ɹæm
pitchy	'pɪ.tʃi
numberless	'nʌm.bʌ.lʌ
twixt	'twɪks
loins	'lɔɪn
rhene	'ɹi
danaw	'dæ.nɔː
godlike	'ɡɑd.laɪ
dignities	'dɪɡ.nɪ.ti
erst	'əːs
thrones	'θɹəʊn
blotted	'blɑ.tɪ
rased	'ɹeɪz
falsities	'fɑl.sɪ.ti
cherubim	'tʃɛ.ɹʉː.bɪ
abominations	æ.`bɑ.mɪ.'neɪ.ʃʌn
profaned	pɹʌ.'feɪn
moloch	'mɑ.lɑ
besmeared	bɪ.'smeɪ.ʌ.ʌ
timbrels	'tɪm.bɹʌl
rabba	'ɹæ.bʌ
argob	'ɑ.ɡɑ
basan	'bæ.sʌ
arnon	'ɑ.nɑ
neighbourhood	'neɪ.bʌ.`hʊə
opprobrious	ɑ.'pɹɑ.bɹɪ.ʌ
hinnom	'hɪ.nʌ
tophet	'tɑ.fɪ
gehenna	'dʒɛ.hɛ.nʌ
chemos	'ki.məʊ
moab's	'məʊb
aroar	'æ.ɹɔː
nebo	'ni.bəʊ
southmost	'saʊθ.məʊs
abarim	æ.'bɑ.ɹɪ
hesebon	'hɛ.sɛ.bʌ
horonaim	'hɑ.ɹʌ.`neɪ
seon's	sɪ.'ɑn
sibma	'sɪb.mʌ
eleale	ɪ.'li
asphaltic	æ.'sfæl.tɪ
peor	pɪ.'ɔː
sittim	'sɪ.tɪ
baalim	'bɑ.lɪ
ashtaroth	'æʃ.tæ.`ɹɑθ
uncompounded	ʌn.kɑm.'paʊn.dɪ
manacled	'mæ.nʌ.kʌl
cumbrous	'kʌm.bɹʌ
fulfil	fʊəl.'fɪ
unfrequented	ʌn.'fɹi.kwʌn.tɪ
astoreth	æ.'stɔː.ɹʌθ
astarte	æ.'stɑ
sidonian	sɪ.'dəʊ.neɪ.ʌ
uxorious	ʌk.'sɔː.ɹɪ.ʌ
idolatresses	'aɪ.dʌ.`læ.tɹʌ.sɪ
thammuz	'θæ.mʌ
damsels	'dæm.sʌl
adonis	æ.'dəʊ.ni
sion's	sɪ.'ɑn
idolatries	aɪ.'dɑ.lʌ.`tɹɪ
lopt	'lɑp
grunsel	'ɡɹʌn.sʌ
azotus	'æ.zɑ.tʌ
ascalon	æ.'skæ.lʌ
accaron	æ.'kæ.ɹʌ
rimmon	'ɹɪ.mʌ
abbana	æ.'bɑ.nʌ
pharphar	'fɑ.fɑ
ahaz	'æ.hæ
sottish	'sɑ.tɪʃ
whereon	'wəː.ɹɑ
osiris	'ɑ.sɪ.`ɹɪ
orus	'ɔː.ɹʌ
sorceries	'sɔː.sʌ.ɹi
bleating	'bli.tɪŋ
belial	bɪ.'lɪ.ʌ
eli's	ɪ.'li
loftiest	'lɑf.tɪ.ʌs
darkens	'dɑ.kʌn
gibeah	'dʒaɪ.bʌ
ionian	aɪ.'ɑ.neɪ.ʌ
javan's	'dʒɑ.væn
rhea's	'ɹi
delphian	'dɛl.feɪ.ʌ
dodona	dʌ.'dəʊ.nʌ
hesperian	hɛ.'speɪ.ʌ.ɹɪ.ʌ
wonted	'wɑn.tɪ
clarions	'klæ.ɹeɪ.ʌn
upreared	'ʌ.pɹeɪ.ʌ.ʌ
honour	'ɑ.nʌ
azazel	'æ.zeɪ.zʌ
emblazed	ɛm.'bleɪz
seraphic	'sɛ.ɹʌ.`fɪ
frighted	'fɹaɪ.tɪ
colours	'kʌ.lʌ
thronging	'θɹɑŋ.ɪŋ
serried	'sɛ.ɹɪ
valour	'væ.lʌ
swage	'swædʒ
visages	'vɪ.sɪ.dʒɪ
distends	dɪ.'stɛnd
phlegra	'flɛ.ɡɹʌ
ilium	'ɪ.leɪ.ʌ
auxiliar	'ɔːk.sɪ.`leɪ.ʌ.ʌ
resounds	ɹɪ.'zaʊnd
uther's	'ʌ.ðʌ
begirt	bɪ.'ɡəː
armoric	ɑ.'mɑ.ɹɪ
jousted	'dʒaʊ.stɪ
aspramont	æ.'spɹæ.mɑn
damasco	dæ.'mæ.skəʊ
marocco	mæ.'ɹɑ.kəʊ
trebisond	'tɹɛ.bɪ.`sɑn
biserta	baɪ.'səː.tʌ
afric	'æ.fɹɪ
charlemain	'tʃɑ.lɪ.`meɪ
fontarabbia	`fɑn.tæ.'ɹæ.beɪ.ʌ
intrenched	ɪn.'tɹɛntʃ
dauntless	'dɔːnt.lʌ
amerced	'æ.məːs
splendours	'splɛn.dʌ
scathed	'skeɪð
whereat	'wəː.ɹæ
assayed	æ.'seɪ
interwove	`ɪn.tʌ.'wəʊ
matchless	'mætʃ.lʌ
forseeing	fɔː.'si.ɪŋ
puissant	'pjʉː.ɪ.sʌn
whereof	'wəː.ɹɑ
favour	'feɪ.vʌ
outflew	aʊt.'flʉː
scurf	'skəː
pickaxe	'pɪ.kæk
forerun	'fɔː.ɹʌ
rampart	'ɹæm.pɑ
mammon	'mæ.mʌ
trodden	'tɹɑ.dʌ
beatific	bi.æ.'tɪ.fɪ
digged	'dɪɡ
sluiced	'slʉːs
scummed	'skʌm
cornice	'kɔː.nɪ
alcairo	æl.'kəː.ɹəʊ
magnificence	mæɡ.'nɪ.fɪ.sʌn
belus	bɪ.'lʉː
serapis	'sɛ.ɹæ.`pi
pendent	'pɛn.dʌn
cressets	'kɹɛ.sɛt
naptha	'næp.θʌ
asphaltus	'æ.sfæl.tʌ
sceptred	'skɛp.tʌ
unadored	ʌ.næ.'dɔː
ausonian	ɔː.'səʊ.neɪ.ʌ
mulciber	'mʌl.sɪ.bʌ
dropt	'dɹɑp
lemnos	'lɛm.nəʊ
aegaean	i.'ɡeɪ.ʌ
erring	'əː.ɹɪŋ
trumpet's	'tɹʌm.pɪt
soldan's	'səʊl.dʌn
paynim	'peɪ.nɪ
expatiate	ɛk.'speɪ.ʃɪ.`eɪ
straitened	'stɹeɪ.tʌn
pygmean	'pɪɡ.meɪ.ʌ
faery	'fəː.ɹi
arbitress	'ɑ.bɪ.tɹʌ
jocund	'dʒɑ.kʌn
incorporeal	ɪn.'kɔː.pɔː.`ɹeɪ.ʌ
ii	`ɹəʊ.mʌn.'tʉː
ormus	'ɔː.mʌ
ind	'ɪn
insatiate	ɪn.'seɪ.ʃɪ.`eɪ
untaught	ʌn.'tɔː
dominions	dʌ.'mɪ.neɪ.ʌn
unenvied	`ʌ.'nɛn.vɪ
thunderer's	'θʌn.dʌ.ɹʌ
recked	'ɹɛk
unexpert	`ʌ.'nɛk.spəː
contriving	kʌn.'tɹaɪ.vɪŋ
resistless	ɹɪ.'sɪst.lʌ
torturer	'tɔː.tʃʌ.ɹʌ
tartarean	tɑ.'təː.ɹeɪ.ʌ
bethink	'bɛ.θɪŋ
benumb	bɪ.'nʌ
unextinguishable	`ʌ.nɛk.'stɪŋ.ɡwɪ.ʃʌ.bʌ
maturest	mʌ.'tʃʊə.ɹʌs
nobler	'nəʊ.blʌ
slothful	'slɑθ.fʌ
scorning	'skɔː.nɪŋ
incorruptible	ɪn.kʌ.'ɹʌp.tʌ.bʌ
unpolluted	ʌn.pʌ.'lʉː.tɪ
baser	'beɪ.zʌ
uncreated	ʌn.kɹi.'eɪ.tɪ
belike	bɪ.'laɪ
amain	'æ.meɪ
besought	bɪ.'sɔː
awaked	æ.'weɪk
intermitted	`ɪn.tʌ.'mɪ.tɪ
firmament	'fəː.mʌ.mʌn
impendent	ɪm.'pɛn.dʌn
wrapt	'ɹæp
unrespited	`ʌn.'ɹɛ.spaɪ.tɪ
unpitied	ʌn.'pɪ.ti
unreprieved	`ʌn.ɹɪ.'pɹiv
dissuades	dɪ.'sweɪd
subdues	sʌbd.'jʉː
ordains	ɔː.'deɪn
venturous	'vɛn.tʃʌ.ɹʌ
vapour	'veɪ.pʌ
reason's	'ɹi.zʌn
counselled	'kaʊn.sʌl
disenthrone	`dɪ.sɛn.'θɹəʊ
unthrone	ʌn.'θɹəʊ
subjection	sʌb.'dʒɛk.ʃʌ
warbled	'wɔː.bʌl
hallelujahs	`hæ.lɪ.'lʉː.jʌ
lordly	'lɔːd.li
odours	'əʊ.dʌ
vassalage	'væ.sæ.lɪdʒ
soe'er	'səʊ.ʌ
unobscured	ʌ.nɑb.'skjʊə
seafaring	'si.fəː.ɹɪŋ
o'erwatched	'ɔː.wɑtʃ
pinnace	'pɪ.nɪ
engraven	ɛn.'ɡɹeɪ.vʌ
atlantean	æt.'lɑn.teɪ.ʌ
noontide	'nʉːn.taɪ
vouchsafed	'vaʊtʃ.seɪf
untamed	ʌn.'teɪm
habitants	'hæ.bɪ.tʌnt
repenting	ɹɪ.'pɛn.tɪŋ
upraise	ʌ.'pɹeɪ
neighbouring	'neɪ.bəː.ɹɪŋ
unvisited	ʌn.'vɪ.zɪ.tɪ
unbottomed	ʌn.'bɑ.tʌm
upborne	ʌp.'bɔː
senteries	'sɛn.tʌ.ɹi
monarchal	'mɑ.nʌ.kʌ
undismayed	ʌn.dɪ.'smeɪ
immures	ɪ.'mjʊə
unessential	ʌ.nɪ.'sɛn.ʃʌ
splendour	'splɛn.dʌ
honoured	'ɑ.nʌ
intermit	`ɪn.tʌ.'mɪ
wakeful	'weɪk.fʌ
o'erspread	'ɔː.spɹɛ
louring	'ləː.ɹɪŋ
scowls	'skaʊl
enow	ɪ.'nəʊ
emblazonry	ɛm.'bleɪ.zɑn.ɹi
horrent	'hɑ.ɹʌn
pythian	'paɪ.θeɪ.ʌ
steeds	'stid
welkin	'wɛl.kɪ
typhoean	'taɪ.fəʊ.ʌ
rend	'ɹɛn
alcides	'æl.saɪd
oechalia	əʊ.'tʃeɪ.leɪ.ʌ
envenomed	ɛn.'vɛ.nʌm
thessalian	θɛ.'seɪ.leɪ.ʌ
lichas	'lɪ.tʃʌ
oeta	'əʊ.tʌ
euboic	'jʉː.bəʊ.ɪ
angelical	æn.'dʒɛ.lɪ.kʌ
enthrall	ɛn.'θɹɔː
ravishment	'ɹæ.vɪʃ.mʌn
foreknowledge	fɔː.'nɑ.lɪdʒ
obdured	'ɑbd.jʊə
acheron	'eɪ.kɹɑ
cocytus	'kɑ.sɪ.tʌ
lamentation	læ.mɪn.'teɪ.ʃʌ
phlegeton	'flɛ.ɡɛ.tʌ
lethe	'lɛð
serbonian	səː.'bəʊ.neɪ.ʌ
betwixt	bɪ.'twɪks
damiata	`deɪ.mɪ.'ɑ.tʌ
casius	'kæ.sɪ.ʌ
parching	'pɑ.tʃɪŋ
frore	'fɹɔː
harpy	'hɑ.pi
furies	'fjʊə.ɹɪ
haled	'heɪl
infixed	ɪn.'fɪks
lethean	'lɛ.θeɪ.ʌ
forgetfulness	fʌ.'ɡɛt.fʌl.nʌ
dolorous	'dɑ.lʌ.ɹʌ
alp	'æl
fens	'fɛn
obominable	'ɑ.bʌ.`mɪ.nʌ.bʌ
inutterable	ɪ.'nʌ.tʌ.ɹʌ.bʌ
chimeras	kaɪ.'meɪ.ʌ.ɹʌ
descried	dɪ.'skɹeɪ
equinoctial	'ɛ.kwɪ.`nɑk.ʃʌ
bengala	bɛŋ.'ɡɑ.lʌ
ternate	'təː.neɪ
tidore	'tɪ.dɔː
cerberean	'səː.bʌ.`ɹeɪ.ʌ
scylla	'saɪ.lʌ
trinacrian	tɹaɪ.'næ.kɹeɪ.ʌ
labouring	'leɪ.bəː.ɹɪŋ
dar'st	'dɑs
miscreated	mɪ.skɹi.'eɪ.tɪ
reckon'st	'ɹɛ.kɑns
thyself	θaɪ.'sɛl
breath'st	'bɹɛθs
unfelt	ʌn.'fɛl
unterrified	ʌn.'tɛ.ɹɪ.`faɪ
ophiuchus	'ɑ.fɪ.`ʌ.tʃʌ
snaky	'sneɪ.ki
sorceress	'sɔː.sʌ.ɹʌ
forbore	'fɔː.bɔː
interposest	`ɪn.tʌ.'pəʊ.sʌs
call'st	'kɔːls
detestable	dɪ.'tɛ.stʌ.bʌ
portress	'pɔː.tɹʌ
likest	'laɪ.kʌs
becam'st	bɪ.'kæms
enamoured	ɪ.'næ.mʌ
took'st	'tʊəks
empyrean	ɛm.'pɪ.ɹeɪ.ʌ
engendering	ɛn.'dʒɛn.dʌ.ɹɪŋ
saw'st	'sɔːs
repast	ɹɪ.'pɑs
forewarn	fɔː.'wɔː
claim'st	'kleɪms
show'st	'ʃəʊs
unthought	ʌn.'θɔː
pretences	pɹɪ.'tɛn.sɪ
purlieus	'pəː.lʉː
surcharged	'səː.tʃɑdʒ
broils	'bɹɔɪl
bespake	bɪ.'speɪ
o'ermatched	'ɔː.mætʃ
tartarus	'tɑ.tɑ.ɹʌ
clamours	'klæ.mʌ
compassed	'kʌm.pʌs
gav'st	'ɡævs
beseems	bɪ.'sim
portcullis	'pɔːt.kʌ.`li
unfastens	ʌn.'fɑ.sʌn
erebus	'ɛ.ɹɪ.bʌ
bannered	'bæ.nʌ
redounding	ɹɪ.'daʊn.dɪŋ
illimitable	ɪ.'lɪ.mɪ.tʌ.bʌ
embryon	'ɛm.bɹɪ.ʌ
unnumbered	ʌn.'nʌm.bʌ
cyrene's	'saɪ.ɹin
embroils	ɛm.'bɹɔɪl
confusedly	kʌn.'fjʉː.sɪd.lɪ
pealed	'pil
bellona	bɛ.'ləʊ.nʌ
vacuity	væ.'kjʉː.ɪ.ti
pennons	'pɛ.nʌn
nitre	'naɪ.tʌ
quenched	'kwɛntʃ
boggy	'bɑ.ɡi
syrtis	'sɪ.ʌ.`ti
behoves	bɪ.'həʊv
gryphon	'ɡɹɪ.fɑ
moory	'mʊə.ɹi
arimaspian	`æ.ɹɪ.'mɑ.speɪ.ʌ
nethermost	'nɛ.ðʌ.`məʊs
enthroned	ɛn.'θɹəʊn
orcus	'ɔː.kʌ
demogorgon	'dɛ.mʌ.`ɡɔː.ɡʌ
darksome	'dɑk.sʌ
readiest	'ɹɛ.dɪ.ʌs
behoof	bɪ.'hʉː
anarch	'æ.nʌ
incomposed	ɪn.kʌm.'pəʊz
environed	ɛn.'vaɪ.ɹʌn
bosporus	'bɑ.spɔː.ɹʌ
justling	'dʒʌ.slɪŋ
larboard	'lɑ.bɔː
charybdis	kʌ.'ɹɪb.dɪ
tamely	'teɪm.li
outmost	'aʊt.məʊs
wafts	'wɑft
accursed	æ.'kəː.sɪ
hies	'haɪ
iii	`ɹəʊ.mʌn.'θɹi
coeternal	`kəʊ.ɪ.'təː.nʌ
unblam'd	ʌn.'blæm
unapproached	ʌ.næ.'pɹəʊtʃ
effluence	'ɛ.flʉː.ʌn
increate	`ɪn.kɹi.'eɪ
hear'st	'heɪ.ʌ.ʌs
formless	'fɔːm.lʌ
escap'd	'ɛ.skæp
orphean	'ɔː.feɪ.ʌ
revisit'st	ɹɪ.'vɪ.zɪts
orbs	'ɔːb
suffusion	sʌ.'fjʉː.ʒʌ
equall'd	'i.kwʌl
thamyris	'θæ.mɪ.`ɹɪ
maeonides	'mi.ʌ.`naɪd
tiresias	'taɪ.ʌ.zeɪ.ʌ
phineus	'faɪ.nɪ.ʌ
darkling	'dɑ.klɪŋ
shadiest	'ʃeɪ.dɪ.ʌs
expung'd	ɛk.'spʌŋ
thron'd	'θɹɑn
highth	'haɪθ
sanctities	'sɑnk.tɪ.ti
receiv'd	ɹɪ.'siv
beatitude	bi.'æ.tɪt.`jʉː
plac'd	'plæk
unrivall'd	ʌn.'ɹaɪ.vʌl
imbosom'd	ɪm.'bɑ.sʌm
prescrib'd	pɹɪ.'skɹɪb
hearken	'hɑ.kʌ
glozing	'ɡləʊ.zɪŋ
faithless	'feɪθ.lʌ
ingrate	ɪn.'ɡɹeɪ
despoil'd	dɪ.'spɔɪl
rul'd	'ɹʌl
dispos'd	dɪ.'spɑz
foreknew	'fɔːkən.`jʉː
unforeknown	ʌn.'fɔː.`nəʊ
immutably	ɪ.'mjʉː.tʌ.blɪ
unchangeable	ʌn.'tʃeɪn.dʒʌ.bʌ
deprav'd	dɪ.'pɹæv
deceiv'd	dɪ.'siv
diffus'd	dɪ.'fʌz
wherewith	wəː.'wɪð
lov'd	'lʌv
judgest	'dʒʌ.dʒʌs
nought	'nɔː
unmake	ʌn.'meɪ
blasphem'd	'blɑ.sfʌm
effectual	ɪ.'fɛk.tʃʉː.ʌ
sav'd	'sæv
vouchsaf'd	'vaʊtʃ.sæf
betimes	bɪ.'taɪm
intercessour	`ɪn.tʌ.'sɛ.sʌ
adjudg'd	æ.'dʒʌdʒ
fulness	'fʌl.nʌ
speediest	'spi.dɪ.ʌs
unprevented	ʌn.pɹɪ.'vɛn.tɪ
unimplor'd	`ʌ.nɪm.'plɔː
unsought	ʌn.'sɔː
unspotted	ʌn.'spɑ.tɪ
vanquisher	'væn.kwɪ.ʃʌ
maugre	'mɔː.ɡʌ
carcase	'kɑ.keɪ
reconcilement	'ɹɛ.kʌn.`saɪl.mʌn
complacence	kʌm.'pleɪ.sʌn
canst	'kæns
unrighteous	ʌn.'ɹaɪ.tʃʌ
ransomed	'ɹæn.sʌm
quitted	'kwɪ.tɪ
princedoms	'pɹɪns.dʌm
triumphing	'tɹaɪ.ʌm.fɪŋ
scepter	'sɛp.tʌ
hosannas	hʌ.'sæ.nʌ
inwove	ɪn.'wəʊ
amarant	'æ.mʌ.`ɹæn
offence	ʌ.'fɛn
fount	'faʊn
elysian	ɛ.'lɪ.zeɪ.ʌ
inwreathed	ɪn.'ɹið
garlands	'ɡɑ.lʌnd
impurpled	ɪm.'pəː.pʌl
quivers	'kwɪ.vʌ
raptures	'ɹæp.tʃʌ
sit'st	'sɪts
shadest	'ʃeɪ.dʌs
similitude	'sɪ.mɪ.`lɪt.jʉː
effulgence	ɪ.'fʌl.dʒʌn
dominations	`dɑ.mɪ.'neɪ.ʃʌn
drovest	'dɹəʊ.vʌs
disarrayed	`dɪ.sæ.'ɹeɪ
purposed	'pəː.pʌs
unexampled	`ʌ.nɛɡ.'zɑm.pʌl
saviour	'seɪ.vjʌ
disjoin	dɪs.'dʒɔɪ
hymning	'hɪ.mɪŋ
opacous	ɑ.'pæ.kʌ
inferiour	ɪn.'feɪ.ʌ.ɹɪ.ʌ
alighted	æ.'laɪ.tɪ
starless	'stɑ.lʌ
vultur	'vʌl.tʃʌ
imaus	ɪ.'maʊ
yeanling	'jin.lɪŋ
hydaspes	'haɪ.dɑsp
sericana	`sɛ.ɹɪ.'kɑ.nʌ
chineses	tʃaɪ.'ni.zɪ
cany	'keɪ.ni
waggons	'wæ.ɡʌn
aereal	'əː.ɹeɪ.ʌ
vapours	'veɪ.pʌ
unaccomplished	ʌ.næ.'kɑm.plɪʃ
unkindly	ʌn.'kaɪnd.li
sennaar	sɛ.'nɑ
babels	'beɪ.bʌl
empedocles	ɛm.'pɛ.dɑ.kʌl
cleombrotus	klɪ.'ɑm.bɹɑ.tʌ
eremites	ɪ.'ɹɛ.maɪt
trumpery	'tɹʌm.pʌ.ɹi
golgotha	ɡʌl.'ɡɑ.θʌ
crystalling	'kɹɪ.stɔː.lɪŋ
cowls	'kaʊl
tost	'tɑs
reliques	ɹɪ.'lik
upwhirled	'ʌp.wəːl
unpeopled	ʌn.'pi.pʌl
untrod	ʌn.'tɹɑ
descries	dɪ.'skɹeɪ
frontispiece	'fɹʌn.tɪz.`pi
padan	'pæ.dʌ
aram	'æ.ɹæ
viewless	'vjʉː.lʌ
behests	bɪ.'hɛst
paneas	'peɪ.neɪ.ʌ
beersaba	'beɪ.ʌ.ʌ.'sɑ.bʌ
glistering	'ɡlɪ.stʌ.ɹɪŋ
pinnacles	'pɪ.nʌ.kʌl
gilds	'ɡɪld
seised	'saɪz
atlantick	æt.'lɑn.tɪ
precipitant	pɹɪ.'sɪ.pɪ.tʌn
eccentrick	'ɛk.sɪn.`tɹɪ
magnetick	'mæɡ.nɪ.`tɪ
wonderously	'wʌn.dʌ.ɹʌ.sli
optick	'ɑp.tɪ
carbuncle	'kɑ.bʌŋ.kʌ
chrysolite	'kɹaɪ.sʌ.`laɪ
proteus	'pɹəʊ.tɪ.ʌ
limbeck	'lɪm.bɛ
chemick	'kɛ.mɪ
humour	'hjʉː.mʌ
colour	'kʌ.lʌ
undazzled	ʌn.'dæ.zʌl
tiar	'taɪ.ʌ
journey's	'dʒəː.nɪ
uriel	'jʊə.ɹi.ʌ
accosts	æ.'kɑst
authentick	ɔː.'θɛn.tɪ
wonderous	'wʌn.dʌ.ɹʌ
quires	'kwaɪ.ʌ
dissembler	dɪ.'sɛm.blʌ
unperceived	ʌn.pʌ.'siv
wisdom's	'wɪs.dʌm
uprightness	'ʌ.pɹaɪt.nʌ
infinitude	ɪn.'fɪ.nɪt.`jʉː
hasted	'heɪ.stɪ
orbicular	ɔː.'bɪ.kjʊə.lʌ
interposes	`ɪn.tʌ.'pəʊ.zɪ
triform	'tɹaɪ.fɔː
superiour	sʉː.'peɪ.ʌɹ.jʌ
ecliptick	ɪ.'klɪp.tɪ
aery	'əː.ɹi
niphates	'nɪ.feɪt
iv	`ɹəʊ.mʌn.'fɔː
revenged	ɹɪ.'vɛndʒ
tempter	'tɛmp.tʌ
horrour	'hɑ.ɹʌ
slumbered	'slʌm.bʌ
lookest	'lʊə.kʌs
recompence	`ɹi.kʌm.'pɛn
sdeined	'ɛs.'deɪn
hadst	'hæds
rues	'ɹʉː
vaunts	'vɔːnt
unsay	ʌn.'seɪ
punisher	'pʌ.nɪ.ʃʌ
exil'd	ɛɡ.'zɪl
distempers	dɪ.'stɛm.pʌ
artificer	'ɑ.tɪ.fɪ.sʌ
practised	'pɹæk.tɪs
demeanour	dɪ.'mi.nʌ
unobserved	ʌ.nɑb.'zəːv
upgrew	ʌp.'ɡɹʉː
insuperable	ɪn.'sʉː.pʌ.ɹʌ.bʌ
stateliest	'steɪt.li.ʌs
verdurous	'vəːd.jʊə.ɹʌ
upsprung	'ʌp.spɹʌŋ
goodliest	'ɡʊəd.li.ʌs
loaden	'ləʊ.dʌ
enamelled	ɪ.'næ.mʌl
landskip	'lænd.skɪ
odoriferous	`əʊ.dʌ.'ɹɪ.fʌ.ɹʌ
mozambick	'mɑ.zæm.`bɪ
sabean	seɪ.'beɪ.ʌ
araby	'æ.ɹæ.bi
asmodeus	æ.'sməʊ.dɪ.ʌ
tobit's	'tɑ.bɪt
hurdled	'həː.dʌl
unhoard	ʌn.'hɔː
clomb	'klɑ
hirelings	'haɪ.ʌ.lɪŋ
auran	'ɔː.ɹʌ
seleucia	'sɛ.lʉː.ʃʌ
telassar	'tɛ.læ.`sɑ
ingulfed	ɪn.'ɡʌlf
crisped	'kɹɪsp
mazy	'meɪ.zi
errour	'ɛ.ɹʌ
unpierced	ʌn.'peɪ.ʌ.ʌs
imbrowned	ɪm.'bɹaʊn
interposed	`ɪn.tʌ.'pəʊz
palmy	'pɑ.mi
irriguous	ɪ.'ɹɪ.ɡjʉː.ʌ
umbrageous	ʌm.'bɹeɪ.dʒʌ
grots	'ɡɹɑt
mantling	'mɑnt.lɪŋ
fringed	'fɹɪndʒ
mirrour	'mɪ.ɹʌ
enna	ɛ.'næ
proserpine	'pɹəʊ.zʌ.`paɪ
orontes	'ɔː.ɹɑnt
castalian	kɑ.'steɪ.leɪ.ʌ
nyseian	'naɪ.seɪ.ʌ
amalthea	æ.'mæl.θeɪ.ʌ
stepdame	'stɛp.deɪ
abassin	æ.'bæ.sɪ
ethiop	'i.θɪ.ʌ
nilus	'nɪ.lʌ
undelighted	`ʌn.dɪ.'laɪ.tɪ
sanctitude	'sɑnk.tɪt.`jʉː
hyacinthine	'haɪ.æ.`sɪn.θaɪ
forelock	'fɔː.lɑ
dishevelled	dɪ.'ʃɛ.vʌl
ringlets	'ɹɪŋ.ɡlʌt
tendrils	'tɛn.dɹʌl
dishonourable	dɪ.'sɑ.nʌ.ɹʌ.bʌ
nectarine	'nɛk.tɑ.`ɹi
recline	ɹɪ.'klaɪ
damasked	'dæ.mɑsk
savoury	'seɪ.vəː.ɹi
thirsted	'θəː.stɪ
frisking	'fɹɪ.skɪŋ
ramped	'ɹæmp
dandled	'dæn.dʌl
pards	'pɑd
gambolled	'ɡæm.bɑl
wreathed	'ɹið
bedward	'bɛ.dwʌ
ruminating	'ɹʉː.mɪ.`neɪ.tɪŋ
publick	'pʌ.blɪ
tyrant's	'taɪ.ɹʌnt
alights	æ.'laɪt
sportful	'spɔːt.fʌ
unespied	ʌ.nɛ.'spaɪ
purlieu	'pəː.lʉː
fawns	'fɔːn
couchant	'kaʊ.tʃʌn
dearer	'deɪ.ʌ.ʌ.ɹʌ
knowest	'nəʊ.ʌs
toilsome	'tɔɪl.sʌ
reposed	ɹɪ.'pəʊz
unexperienced	`ʌ.nɛk.'speɪ.ʌ.ɹɪ.ʌns
pined	'paɪn
invisibly	ɪn.'vɪ.zʌ.bli
espied	ɛ.'spaɪ
platane	'plæ.teɪ
methought	'mɛ.θɔː
cryedst	'kɹaɪ.ɛds
flyest	'flaɪ.ʌs
unreproved	`ʌn.ɹɪ.'pɹʉːv
impregns	ɪm.'pɹɛɡən
mayflowers	'meɪ.flaʊ.ʌ
leer	'leɪ.ʌ.ʌ
plained	'pleɪn
imparadised	ɪm.'pæ.ɹæ.`daɪz
reasonless	'ɹi.zʌn.lʌ
unspied	ʌn.'spaɪ
overhung	`əʊ.vʌ.'hʌŋ
angelick	'æn.dʒɪ.`lɪ
heroick	'heɪ.ʌ.ɹəʊ.`ɪ
armoury	'ɑ.məː.ɹi
almighty's	ɑl.'maɪ.ti
warriour	'wɑɹ.jʌ
sitst	'sɪts
corporeal	'kɔː.pɔː.`ɹeɪ.ʌ
tellest	'tɛ.lʌs
volubil	'vɑ.lʉː.`bɪ
arraying	æ.'ɹeɪ.ɪŋ
slunk	'slʌŋ
descant	'dɛ.skæn
sapphires	'sæ.faɪ.ʌ
hesperus	'hɛ.spʌ.ɹʌ
slumbrous	'slʌm.bɹʌ
unactive	ʌ.'næk.tɪ
arbours	'ɑ.bʌ
manuring	mʌn.'jʊə.ɹɪŋ
unsmooth	ʌn.'smʉːð
bidst	'bɪds
unargued	ʌ.'nɑ.ɡjʉː
ministring	'mɪ.nɪ.stɹɪŋ
unbeheld	ʌn.bɪ.'hɛl
harmonick	'hɑ.mʌ.`nɪ
inwoven	ɪn.'wəʊ.vʌ
acanthus	æ.'kɑn.θʌ
beauteous	'bjʉː.teɪ.ʌ
jessamin	'dʒɛ.sæ.`mɪ
mosaick	'mɑ.seɪ
broidered	'bɹɔɪ.dʌ
shadier	'ʃeɪ.dɪ.ʌ
faunus	'fɔː.nʌ
hymenaean	`haɪ.mʌ.'neɪ.ʌ
unwiser	ʌn.'waɪ.zʌ
japhet	'dʒæ.fɪ
jove's	'dʒəʊv
madest	'meɪ.dʌs
partakers	'pɑ.teɪ.kʌ
uncropt	ʌn.'kɹɑp
ween	'wi
connubial	kʌn.'jʉː.bɪ.ʌ
defaming	dɪ.'feɪ.mɪŋ
encrease	ɛn.'kɹi
unbefitting	ʌn.bɪ.'fɪ.tɪŋ
domestick	dʌ.'mɛ.stɪ
undefiled	`ʌn.dɪ.'faɪl
harlots	'hɑ.lɑt
joyless	'dʒɔɪ.lʌ
unendeared	`ʌ.nɛn.'deɪ.ʌ.ʌ
amours	'æ.mʌ
serenate	'sɛ.ɹɪ.`neɪ
nightingales	'naɪ.tɪŋ.`ɡeɪl
sublunar	sʌ.'blʉː.nʌ
uzziel	'ʌ.zi
ithuriel	ɪ.'θjʊə.ɹi.ʌ
zephon	'zɛ.fɑ
unsearched	ʌn.'səːtʃ
hitherward	'hɪ.ðʌ.wʌ
seise	'saɪ
assaying	æ.'seɪ.ɪŋ
phantasms	'fɑn.tæ.zʌm
distempered	dɪ.'stɛm.pʌ
conceits	kʌn.'sit
ingendering	ɪn.'dʒɛn.dʌ.ɹɪŋ
falshood	'fɑl.ʃʊə
tun	'tʌ
rumoured	'ɹʉː.mʌ
smutty	'smʌ.ti
stept	'stɛp
comest	kʌ.'mɛs
superfluous	sʉː.'pəː.flʉː.ʌ
stoodest	'stʊə.dʌs
resemblest	ɹɪ.'sɛm.blʌs
champing	'tʃæm.pɪŋ
lours	'ləː
wouldst	'wʊəds
mightst	'maɪts
durance	'djʊə.ɹʌn
disdainfully	dɪs.'deɪn.fʌ.lɪ
incurrest	ɪn.'kʌ.ɹɛs
vollied	'vɑ.li
assays	æ.'seɪ
couldst	'kʊəds
faithfulness	'feɪθ.fʌl.nʌ
fawned	'fɔːn
servilely	'səː.vaɪl.li
arreed	æ.'ɹi
fledst	'flɛds
limitary	'lɪ.mɪ.tʌ.ɹi
compeers	kʌm.'peɪ.ʌ.ʌ
drawest	'dɹɔːs
mooned	'mʉːn
threshing	'θɹɛ.ʃɪŋ
teneriff	'tɛ.nʌ.`ɹɪ
unremoved	`ʌn.ɹɪ.'mʉːv
plumed	'plʉːm
astrea	æ.'stɹeɪ.ʌ
counterpoise	'kaʊn.tʌ.`pɔɪ
waked	'weɪk
customed	'kʌ.stʌm
rills	'ɹɪl
aurora's	æ.'ɹɔː.ɹʌ
matin	'mæ.tɪ
unwakened	ʌn.'weɪ.kʌn
discomposed	dɪ.'skɑm.pəʊz
unquiet	ʌn.'kwaɪ.ʌ
zephyrus	'zɛ.fɪ.ɹʌ
morrow's	'mɑ.ɹəʊ
sleepest	'sli.pʌs
laboured	'leɪ.bʌ
orbed	'ɔːb
deigns	'deɪn
cropt	'kɹɑp
mayest	'meɪ.ʌs
exaltation	ɛɡ.zæl.'teɪ.ʃʌ
disjoining	dɪs.'dʒɔɪ.nɪŋ
mimick	'mɪ.mɪ
misjoining	mɪs.'dʒɔɪ.nɪŋ
methinks	mi.'θɪŋk
choisest	'tʃɔɪ.sʌs
bosomed	'bʊə.sʌm
arborous	'ɑ.bʌ.ɹʌ
eden's	'i.dʌn
orisons	'ɑ.ɹɪ.sʌn
unmeditated	ʌn.'mɛ.dɪ.`teɪ.tɪ
tuneable	'tjʉː.nʌ.bʌ
crownest	'kɹaʊ.nʌs
circlet	'səː.klʌ
climbest	'klaɪ.mʌs
fallest	'fɔː.lʌs
meetest	'mi.tʌs
mystick	'mɪ.stɪ
quaternion	'kwæ.tʌ.`neɪ.ʌ
multiform	'mʌl.tɪ.`fɔː
exhalations	ɛks.hæ.'leɪ.ʃʌn
uncoloured	ʌn.'kʌ.lʌ
warble	'wɔː.bʌ
bounteous	'baʊn.teɪ.ʌ
spoused	'spaʊs
twines	'twaɪn
marriageable	'mæ.ɹɪ.dʒʌ.bʌ
deigned	'deɪn
seventimes	'sɛ.vɪn.`taɪm
hearest	'heɪ.ʌ.ʌ.ɹʌs
findest	'faɪn.dʌs
mutable	'mjʉː.tʌ.bʌ
withal	wɪ.'ðæ
transgressing	tɹæns.'ɡɹɛ.sɪŋ
surprisal	sʌ.'pɹɪ.sʌ
unadmonished	ʌ.næd.'mɑ.nɪʃ
unforewarned	ʌn.fɔː.'wɔːn
ardours	'ɑ.dʌ
unconformed	ʌn.kʌn.'fɔːm
delos	dɪ.'ləʊ
kens	'kɛn
winnows	'wɪ.nəʊ
fowls	'faʊl
lineaments	'lɪ.neɪ.ʌ.mʌnt
dipt	'dɪp
tinctured	'tɪŋk.tʃʌ
maia's	'meɪ.ʌ
wantoned	'wɑn.tʌn
disrelish	'dɪs.ɹɛ.lɪʃ
nectarous	'nɛk.tæ.ɹʌ
vouchsafe	'vaʊtʃ.seɪ
disburthening	dɪs.'bəː.ðʌ.nɪŋ
juciest	'dʒʌ.sɪ.ʌs
dispatchful	dɪ.'spætʃ.fʌ
inelegant	ɪ.'nɛ.lɪ.ɡʌn
kindliest	'kɪnd.li.ʌs
bestirs	bɪ.'stəː
pontus	'pɑn.tʌ
punick	'pjʉː.nɪ
alcinous	'æl.sɪ.nʌ
meaths	'miθ
strows	'stɹəʊ
unfumed	ʌn.'fjʉːm
perfections	pʌ.'fɛk.ʃʌn
dazzles	'dæ.zʌl
croud	'kɹaʊ
submiss	sʌb.'mɪ
o'ershades	'ɔː.ʃeɪd
pomona's	pʌ.'məʊ.nʌ
flowerets	'flaʊ.ʌ.ɹʌt
undecked	`ʌn.'dɛk
salutation	`sæ.lʉː.'teɪ.ʃʌ
mossy	'mɑ.si
nourisher	'nʌ.ɹɪ.ʃʌ
unmeasured	ʌn.'mɛ.ʒʌ
unsavoury	ʌn.'seɪ.vəː.ɹi
ingrateful	ɪn.'ɡɹeɪt.fʌ
intelligential	ɪn.`tɛ.lɪ.'dʒɛn.ʃʌ
unpurged	ʌn.'pəːdʒ
alimental	æ.laɪ.'mɛn.tʌ
sups	'sʌp
fruitage	'fɹʉː.tɪdʒ
mellifluous	mɛ.'lɪ.flʉː.ʌ
viands	'vaɪ.ʌnd
concoctive	kʌn.'kɑk.tɪ
transubstantiate	tɹæn.sʌb.'stæn.ʃɪ.`eɪ
redounds	ɹɪ.'daʊnd
empirick	ɛm.'pɪ.ɹɪ
drossiest	'dɹɑ.sɪ.ʌs
ministered	'mɪ.nɪ.stʌ
liquours	'lɪ.kwʌ
unlibidinous	ʌn.lɪ.'bɪ.dɪ.nʌ
hierarch	'haɪ.ʌ.ɹɑ
spiritous	'spɪ.ɹɪ.tʌ
oftest	'ɑf.tʌs
nutriments	'njʉː.tɹɪ.mʌnt
paradises	'pæ.ɹʌ.`daɪ.sɪ
favourable	'feɪ.vʌ.ɹʌ.bʌ
continuest	kʌn.'tɪn.jʉː.ʌs
inextricable	`ɪ.nɛk.'stɹɪ.kʌ.bʌ
instructer	ɪn.'stɹʌk.tʌ
cherubick	'tʃɛ.ɹʉː.`bɪ
assenting	æ.'sɛn.tɪŋ
enjoinest	ɛn.'dʒɔɪ.nʌs
surmounts	sʌ.'maʊnt
hierarchs	'haɪ.ʌ.ɹɑk
gonfalons	'ɡɑn.fæ.lʌn
imblazed	ɪm.'bleɪz
inexpressible	`ɪ.nɛk.'spɹɛ.sʌ.bʌ
imbosomed	ɪm.'bɑ.sʌm
unrevoked	`ʌn.ɹɪ.'vəʊk
gerent	'dʒɹɛn
disobeys	`dɪ.səʊ.'beɪ
intervolved	`ɪn.tʌ.'vɑlv
rubied	'ɹʉː.bi
quaff	'kwɑ
roseate	'ɹəʊ.zeɪ
unsleeping	ʌn.'sli.pɪŋ
globous	'ɡlɑ.bʌ
tabernacles	'tæ.bʌ.nʌ.kʌl
unworshipt	ʌn.'wəː.ʃɪp
unobeyed	ʌ.nəʊ.'beɪ
rememberest	ɹɪ.'mɛm.bʌ.ɹʌs
disincumbered	`dɪ.sɪn.'kʌm.bʌ
hierarchal	'haɪ.ʌ.ɹɑ.tʃʌ
abstrusest	æb.'stɹʉː.sʌs
resplendence	ɹɪ.'splɛn.dʌn
anciently	'eɪn.ʃʌnt.li
laughest	'lɑ.fʌs
tumults	'tjʉː.mʌlt
impearls	ɪm.'pəːl
regencies	'ɹi.dʒʌn.si
globose	'ɡlɑ.bəʊ
calumnious	kæ.'lʌm.nɪ.ʌ
magnifick	'mæɡ.nɪ.`fɪ
honours	'ɑ.nʌ
controul	'kɑn.tɹaʊ
abdiel	'æb.di
obloquy	'ɑ.blʌ.`kwɪ
sayest	'seɪ.ʌs
unsucceeded	ʌn.sʌk.'si.dɪ
puissance	'pjʉː.ɪ.sʌn
supplication	`sʌ.plɪ.'keɪ.ʃʌ
beseeching	bɪ.'si.tʃɪŋ
uncreate	ʌn.kɹi.'eɪ
unseduced	ʌn.sɪd.'jʉːs
dreadless	'dɹɛd.lʌ
unpursued	ʌn.pʌs.'jʉː
champain	'tʃæm.peɪ
unbarred	ʌn.'bɑ
procinct	'pɹɑ.sɪŋk
acclamations	æ.klæ.'meɪ.ʃʌn
quadrate	'kwɑ.dɹeɪ
ardour	'ɑ.dʌ
indissolubly	`ɪn.'dɪ.sʌ.`lʌ.bli
straitening	'stɹeɪ.tʌ.nɪŋ
upbore	ʌp.'bɔː
terrene	'tɛ.ɹi
battailous	'bæ.teɪ.lʌ
weened	'win
envier	'ɛn.vɪ.ʌ
aspirer	æ.'spaɪ.ʌ.ɹʌ
terrour	'tɛ.ɹʌ
whelmed	'wɛlm
returnest	ɹɪ.'təː.nʌs
minstrelsy	'mɪn.stɹɛl.si
servility	səː.'vɪ.lɪ.ti
errest	'ɛ.ɹɛs
depravest	dɪ.'pɹeɪ.vʌs
lewdly	'lʉːd.li
darest	'dəː.ɹʌs
saidst	'sɛds
upstaid	ʌp.'steɪ
sidelong	'saɪd.lɑŋ
hosanna	hʌ.'sæ.nʌ
clamour	'klæ.mʌ
brayed	'bɹeɪ
vollies	'vɑ.li
inextinguishable	`ɪ.nɛk.'stɪŋ.ɡwɪ.ʃʌ.bʌ
surceased	'səː.sis
plenteous	'plɛn.teɪ.ʌ
unvanquished	ʌn.'væn.kwɪʃ
shouldst	'ʃʊəds
callest	'kæ.lʌs
fablest	'feɪ.blʌs
parle	'pɑ
smite	'smaɪ
writhed	'ɹaɪð
convolved	kʌn.'vɑlv
griding	'ɡɹaɪ.dɪŋ
discontinuous	`dɪ.skʌn.'tɪn.jʉː.ʌ
necturous	'nɛk.tʃʌ.ɹʌ
annihilating	æ.'naɪ.ʌ.`leɪ.tɪŋ
cloven	'kləʊ.vʌ
adramelech	æ.'dɹeɪm.lɛtʃ
asmadai	æ.'smæ.daɪ
unmindful	ʌn.'maɪnd.fʌ
arioch	'æ.ɹɪ.`ɑ
ramiel	'ɹæ.mi
eternize	ɪ.'təː.naɪ
illaudable	ɪ.'lɔː.dʌ.bʌ
dispraise	dɪ.'spɹeɪ
strown	'stɹəʊ
charioteer	`tʃæ.ɹeɪ.ʌ.'teɪ.ʌ.ʌ
satanick	'seɪ.tʌ.`nɪ
cubick	'kjʉː.bɪ
impenetrably	ɪm.'pɛ.nɪ.tɹʌ.blɪ
unwearied	ʌn.'weɪ.ʌ.ʌ.ɹɪ
unobnoxious	ʌ.nɑb.'nɑk.ʃʌ
foughten	'fɔː.tʌ
encamping	ɛn.'kæm.pɪŋ
pretence	pɹɪ.'tɛn
powerfullest	'paʊ.ʌ.`fʊə.lʌs
contemned	kʌn.'tɛm
imperishable	ɪm.'pɛ.ɹɪ.ʃʌ.bʌ
upstood	ʌp.'stʊə
nisroch	'nɪs.ɹɑ
havock	'hæ.vɑ
unpained	ʌn.'peɪn
avails	æ.'veɪl
repine	ɹɪ.'paɪ
calmest	'kɑ.mʌs
unwounded	ʌn.'wʉːn.dɪ
uninvented	`ʌ.nɪn.'vɛn.tɪ
aright	ʌ.'ɹaɪ
believest	bɪ.'li.vɛs
ethereous	'i.θʌ.`ɹeɪ.ʌ
spume	'spjʉː
o'erwhelm	'ɔː.wɛl
thunderer	'θʌn.dʌ.ɹʌ
inventer	ɪn.'vɛn.tʌ
unfound	ʌn.'faʊn
adusted	æ.'dʌ.stɪ
refulgent	ɹɪ.'fʌl.dʒʌn
zophiel	'zɑ.fi
warriours	'wɑɹ.jʌ
enginery	'ɛn.dʒɪ.nʌ.ɹi
scoffing	'skɑ.fɪŋ
gaped	'ɡeɪp
tipt	'tɪp
embowelled	ɛm.'baʊ.ʌl
disgorging	dɪs.'ɡɔː.dʒɪŋ
displode	dɪ.'spləʊ
gamesome	'ɡeɪm.sʌ
hightened	'haɪ.tʌn
promontories	'pɹɑ.mʌn.tʌ.`ɹi
betook	bɪ.'tʊə
uptore	'ʌp.tʌ
jaculation	`dʒæ.kjʊə.'leɪ.ʃʌ
overspread	`əʊ.vʌ.'spɹɛ
shrined	'ʃɹaɪn
assessour	æ.'sɛ.sʌ
insensibly	ɪn.'sɛn.sʌ.bli
unction	ʌnk.tɪ.'ɑ
ineffably	ɪ.'nɛ.fʌ.blɪ
seek'st	'siks
declarest	dɪ.'kləː.ɹʌs
gladlier	'ɡlæd.li.ʌ
lovest	'lʌ.vɛs
hatest	'heɪ.tʌs
terrours	'tɛ.ɹʌ
mildness	'maɪld.nʌ
unfeigned	ʌn.'feɪn
halleluiahs	`hæ.lɪ.'lʉː.jʌ
undrawn	ʌn.'dɹɔː
convoyed	'kɑn.vɔɪ
careering	kʌ.'ɹeɪ.ʌ.ʌ.ɹɪŋ
showery	'ʃaʊ.ʌ.ɹi
urim	'jʊə.ɹɪ
effusion	ɪ.'fjʉː.ʒʌ
circumfused	'səː.kʌm.`fjʉːz
imbodied	ɪm.'bɑ.dɪ
insensate	ɪn.'sɛn.seɪ
perverseness	pʌ.'vəː.snʌ
weening	'wi.nɪŋ
invincibly	ɪn.'vɪn.sʌ.blɪ
s'preme	'ɛ.'spɹi
appertains	æ.'pəː.teɪn
emulous	'ɛ.mjʊə.lʌ
stedfast	'stɛd.fɑs
helmed	'hɛlm
visaged	'vɪ.sɪdʒ
spiritless	'spɪ.ɹɪt.lʌ
unsufferable	ʌn.'sʌ.fʌ.ɹʌ.bʌ
affrighted	æ.'fɹaɪ.tɪ
incumbered	ɪn.'kʌm.bʌ
unquenchable	ʌn.'kwɛn.tʃʌ.bʌ
disburdened	dɪs.'bəː.dʌn
befel	bɪ.'fɛ
envies	'ɛn.vɪ
vii	`ɹəʊ.mʌn.'sɛ.vʌ
urania	jʊə.'ɹeɪ.neɪ.ʌ
pegasean	`pɛ.ɡeɪ.'seɪ.ʌ
dwellest	'dwɛ.lʌs
unreined	ʌn.'ɹeɪn
bellerophon	'bɛ.lʌ.`ɹɑ.fʌ
dismounted	dɪ.'smaʊn.tɪ
aleian	æ.'leɪ.ʌ
visitest	'vɪ.zaɪ.tʌs
slumbers	'slʌm.bʌ
revellers	'ɹɛ.vɛ.lʌ
thracian	'θɹeɪ.ʃeɪ.ʌ
rhodope	'ɹəʊ.dʌ
apostasy	æ.'pɑ.stʌ.si
apostates	æ.'pɑ.steɪt
consorted	kʌn.'sɔː.tɪ
redounded	ɹɪ.'daʊn.dɪ
blessedness	'blɛst.nʌ
sinless	'sɪn.lʌ
drouth	'dɹaʊθ
deign	'deɪ
interfused	`ɪn.tʌ.'fjʉːz
floried	'flɔː.ɹɪ
unforbid	ʌn.fʌ.'bɪ
unapparent	ʌ.næ.'pæ.ɹʌn
oppresses	ʌ.'pɹɛ.sɪ
ministeries	'mɪ.nɪ.stʌ.ɹi
dispeopled	dɪ.'spi.pʌl
uncircumscribed	ʌn.'səː.kʌm.`skɹaɪb
habitations	`hæ.bɪ.'teɪ.ʃʌn
sapience	'sæ.peɪ.ʌn
equipage	'ɛ.kwɪ.`pɪdʒ
omnifick	ɑm.'nɪ.fɪ
compasses	'kʌm.pʌ.sɪ
profundity	pɹʌ.'fʌn.dɪ.ti
tartareous	'tɑ.təː.ɹʌ
conglobed	kʌn.'ɡləʊb
disparted	dɪ.'spɑ.tɪ
sphered	'sfəː
sojourned	'səʊ.dʒəːn
uncelebrated	ʌn.'sɛ.lʌ.`bɹeɪ.tɪ
exhaling	ɛks.'heɪ.lɪŋ
uttermost	'ʌ.tʌ.`məʊs
circumfluous	'səː.kʌm.`flʉː.ʌ
prolifick	pɹʌ.'lɪ.fɪ
upheave	ʌp.'hi
tumid	'tjʉː.mɪ
precipitance	pɹɪ.'sɪ.pɪ.tʌn
uprolled	'ʌ.pɹəʊl
conglobing	kʌn.'ɡləʊ.bɪŋ
oose	'ʉː
desart	dɪ.'sɑ
verdure	'vəːd.jʊə
frizzled	'fɹɪ.zʌl
gemmed	'dʒɛm
altern	'ɑl.tʌ
unlightsome	ʌn.'laɪt.sʌ
urns	'əːn
dividual	dɪ.'vɪ.dʒʉː.ʌ
spangling	'spæŋ.ɡʌ.lɪŋ
plenteously	'plɛn.teɪ.ʌ.sli
sculls	'skʌl
nutriment	'njʉː.tɹɪ.mʌn
promontory	'pɹɑ.mʌn.tʌ.`ɹi
spouts	'spaʊt
eyries	'aɪ.ɹɪ
solaced	'sɑ.lɪs
oary	'ɔː.ɹi
solemnized	'sɑ.lɪm.`naɪz
teemed	'tim
innumerous	ɪn.'jʉː.mʌ.ɹʌ
wons	'wʌn
pasturing	'pɑs.tʃʌ.ɹɪŋ
clods	'klɑd
calved	'kɑv
pawing	'pɔː.ɪŋ
brinded	'bɹɪn.dɪ
libbard	'lɪ.bʌ
hillocks	'hɪ.lʌk
upheaved	ʌp.'hiv
liveries	'lɪ.vʌ.ɹi
minims	'mɪ.nɪm
corpulence	'kɔː.pjʊə.lʌn
parsimonious	`pɑ.sɪ.'məʊ.nɪ.ʌ
commonalty	'kɑ.mʌ.nʌl.ti
waxen	'wæk.sʌ
gavest	'ɡeɪ.vʌs
subtlest	'sʌt.lʌs
terrifick	'tɛ.ɹɪ.`fɪ
mover's	'mʉː.vʌ
becamest	bɪ.'keɪ.mʌs
eatest	'i.tʌs
diest	'dis
desisting	dɪ.'sɪ.stɪŋ
acclamation	æ.klæ.'meɪ.ʃʌ
symphonious	sɪm.'fəʊ.nɪ.ʌ
heardst	'həːds
forerunning	'fɔː.ɹʌ.nɪŋ
tunings	'tjʉː.nɪŋ
censers	'sɛn.sʌ
impiously	ɪm.pɪ.ʌ.'sli
usest	'jʉː.zʌs
createst	kɹi.'eɪ.tʌs
hyaline	'haɪ.ʌ.`laɪ
seekest	'si.kʌs
viii	`ɹəʊ.mʌ.'neɪ
unsearchable	ʌn.'səː.tʃʌ.bʌ
punctual	'pʌŋk.tʃʉː.ʌ
disproportions	`dɪ.spɹʌ.'pɔː.ʃʌn
sumless	'sʌm.lʌ
lowliness	'ləʊ.li.nʌ
majestick	'mæ.dʒɪ.`stɪ
tendance	'tɛn.dʌn
auditress	'ɔː.dɪ.tɹʌ
relater	ɹɪ.'leɪ.tʌ
caresses	kʌ.'ɹɛ.sɪ
fabrick	'fæ.bɹɪ
unbuild	ʌn.'bɪl
centrick	'sɛn.tɹɪ
epicycle	'ɛ.pɪ.`saɪ.kʌ
supposest	'sʌ.pəʊ.sʌs
officious	ʌ.'fɪ.ʃʌ
habitant	'hæ.bɪ.tʌn
thinkest	'θɪŋ.kʌs
obliquities	ʌ.'blɪ.kwɪ.ti
rhomb	'ɹɑ
transpicuous	tɹæn.'spɪ.kjʉː.ʌ
unpossessed	ʌn.pʌ.'zɛs
sollicit	'sɑ.lɪ.`sɪ
impertinence	ɪm.'pəː.tɪ.nʌn
unpractised	ʌn.'pɹæk.tɪs
unseasonable	ʌn.'si.zʌ.nʌ.bʌ
pleasantest	'plɛ.zɑn.tʌs
satiety	sæ.'taɪ.ʌ.tɪ
ungraceful	ʌn.'ɡɹeɪ.sfʌ
ineloquent	ɪ.'nɛ.lʌ.kwʌn
comeliness	'kʌm.lɪ.nʌ
barricadoed	'bæ.ɹɪ.`kæ.dəʊ
thitherward	'ðɪ.ðʌ.wʌ
endeavouring	ɛn.'dɛ.vəː.ɹɪŋ
o'erflowed	'ɔː.fləʊ
droused	'dɹaʊs
insensible	ɪn.'sɛn.sʌ.bʌ
soughtest	'sɔː.tʌs
surpassest	sʌ.'pɑ.sʌs
partakes	pɑ.'teɪk
contemptibly	kʌn.'tɛmp.tʌ.blɪ
deprecation	`dɛ.pɹɪ.'keɪ.ʃʌ
unequals	ʌ.'ni.kwʌl
lioness	'laɪ.ʌ.nɛ
fitly	'fɪt.li
proposest	pɹʌ.'pəʊ.sʌs
deficience	dɪ.'fɪ.ʃʌn
secresy	'sɛ.kɹʌ.si
deified	'deɪ.faɪ
unmeet	ʌn.'mi
spakest	'speɪ.kʌs
sawest	'sɔːs
couldest	'kʊə.dʌs
abjure	æbdʒ.'jʊə
forbear	'fɔː.bəː
enviest	'ɛn.vɪ.ʌs
selectest	sɪ.'lɛk.tʌs
gratulation	'ɡɹæ.tʃʊə.'leɪ.ʃʌ
disporting	dɪ.'spɔː.tɪŋ
beauty's	'bjʉː.ti
subducting	'sʌb.dʌk.tɪŋ
loveliness	'lʌv.li.nʌ
virtuousest	'vəː.tʃʉː.`aʊ.sʌs
discreetest	dɪ.'skɹi.tʌs
discountenanced	'dɪ.skaʊn.tʌ.nʌns
nobleness	'nəʊ.bʌl.nʌ
diffident	'dɪ.fɪ.dʌn
needest	'ni.dʌs
overmuch	`əʊ.vʌ.'mʌtʃ
perceivest	pʌ.'si.vɛs
admirest	æd.'maɪ.ʌs
cherishing	'tʃɛ.ɹɪ.ʃɪŋ
honouring	'ɑ.nəː.ɹɪŋ
decencies	'di.sʌn.si
blamest	'bleɪ.mʌs
irradiance	'ɪ.ɹeɪ.`deɪ.ʌn
enjoyest	ɛn.'dʒɔɪ.ʌs
weal	'wi
persevering	`pəː.sɪ.'veɪ.ʌ.ʌ.ɹɪŋ
arbitrement	'ɑ.bɪ.`tɹɪ.mʌn
ix	`ɹəʊ.mʌn.'naɪ
venial	'vi.nɪ.ʌ
tragick	'tɹæ.dʒɪ
turnus	'təː.nʌ
disespous'd	`dɪ.sɛ.'spaʊz
neptune's	'nɛpt.jʉːn
cytherea's	`sɪ.θʌ.'ɹeɪ.ʌ
patroness	'pæ.tɹəʊ.nʌ
unpremeditated	ʌn.pɹɪ.'mɛ.dɪ.`teɪ.tɪ
sedulous	'sɛd.jʊə.lʌ
imblazon'd	ɪm.'bleɪ.zʌn
caparisons	'kæ.pæ.`ɹɪ.sʌn
seneshals	'sɛ.nɛ.ʃʌl
meditated	'mɛ.dɪ.`teɪ.tɪ
compassing	'kʌm.pʌ.sɪŋ
foreworned	'fɔː.wɔːn
colure	'kɑ.lʊə
maeotis	mi.'əʊ.ti
ob	'ɑ
antarctick	'æn.tɑk.`tɪ
irresolute	ɪ.'ɹɛ.zʌ.`lʉː
sleights	'slaɪt
diabolick	'daɪ.ʌ.`bɑ.lɪ
plaints	'pleɪnt
concentring	kʌn.'sɛn.tɹɪŋ
centring	'sɛn.tɹɪŋ
receivest	ɹɪ.'si.vɛs
contraries	'kɑn.tɹʌ.`ɹɪ
adorers	æ.'dɔː.ɹʌ
imbrute	ɪm.'bɹʉː
basest	'beɪ.sʌs
favourite	'feɪ.vʌ.ɹɪ
subtile	'sʌb.taɪ
nocent	'nəʊ.sʌn
unfeared	ʌn.'feɪ.ʌ.ʌ
labours	'leɪ.bʌ
woodbine	'wʊəd.baɪ
clasping	'klɑ.spɪŋ
intermits	`ɪn.tʌ.'mɪt
unpraised	ʌn.'pɹeɪz
houshold	'haʊ.ʃəʊl
debar	dɪ.'bɑ
envying	'ɛn.vɪ.ɪŋ
dishonour	dɪ.'sɑ.nʌ
seemliest	'sim.li.ʌs
unkindness	ʌn.'kaɪnd.nʌ
fearest	'feɪ.ʌ.ʌ.ɹʌs
asperses	æ.'spəː.sɪ
misdeem	mɪs.'di
contemn	kʌn.'tɛ
unassayed	ʌ.næ.'seɪ
exteriour	ɛk.'steɪ.ʌ.ɹɪ.ʌ
enjoins	ɛn.'dʒɔɪn
suborned	'sʌ.bɔːn
securer	sɪ.'kjʊə.ɹʌ
seemest	'si.mʌs
absents	'æb.sʌnt
oread	'ɔː.ɹi
dryad	'dɹaɪ.æ
delia's	'di.leɪ.ʌ
vertumnus	'vəː.tʌm.nʌ
foundst	'faʊnds
rancour	'ɹɑn.kʌ
despoiled	dɪ.'spɔɪl
rivulet	'ɹɪ.vjʊə.lʌ
chanced	'tʃɑns
specked	'spɛk
unsustained	ʌn.sʌ.'steɪn
upstays	ʌp.'steɪ
arborets	'ɑ.bɑ.ɹʌt
imbordered	ɪm.'bɔː.dʌ
laertes	'ləːt
sapient	'sæ.peɪ.ʌn
adjoined	æ.'dʒɔɪn
conceives	kʌn.'siv
tedded	'tɛ.dɪ
kine	'kaɪ
plat	'plæ
overawed	`əʊ.vʌ.'ɹɔː
rapine	'ɹæ.paɪ
fierceness	'feɪ.ʌ.ʌ.snʌ
gratulating	'ɡɹæ.tʃʊə.`leɪ.tɪŋ
informidable	ɪn.fɔː.'mɪ.dʌ.bʌ
indented	`ɪn.'dɛn.tɪ
illyria	ɪ.'lɪ.ɹeɪ.ʌ
hermione	həː.'maɪ.ʌ.ni
epidaurus	'ɛ.pɪ.`dɔː.ɹʌ
ammonian	æ.'məʊ.neɪ.ʌ
skilful	'skɪl.fʌ
steersmen	'steɪ.ʌ.ʌz.mɛ
foreland	'fɔː.lʌn
rusling	'ɹʌ.slɪŋ
disport	dɪ.'spɔː
duteous	'djʉː.teɪ.ʌ
circean	'səː.seɪ.ʌ
organick	'ɔː.ɡæ.`nɪ
beholders	bɪ.'həʊl.dʌ
glozed	'ɡləʊz
proem	'pɹəʊ
marvelling	'mɑ.vʌ.lɪŋ
unamazed	ʌ.næ.'meɪz
camest	'keɪ.mʌs
speakable	'spi.kʌ.bʌ
guileful	'ɡaɪl.fʌ
commandest	kʌ.'mɑn.dʌs
odour	'əʊ.dʌ
unsucked	ʌn.'sʌk
persuaders	pʌ.'sweɪ.dʌ
importune	`ɪm.pɔːt.'jʉː
overpraising	`əʊ.vʌ.'pɹeɪ.zɪŋ
disburden	dɪs.'bəː.dʌ
unctuous	ʌnkt.'jʉː.ʉː
condenses	kʌn.'dɛn.sɪ
delusive	dɪ.'lʉː.sɪ
succour	sʌ.'kəː
glistered	'ɡlɪ.stʌ
credulous	'kɹɛd.jʊə.lʌ
guilefully	'ɡaɪl.fʌ.lɪ
threatener	'θɹɛ.tʌ.nʌ
whoso	'hʉː.səʊ
impregned	ɪm.'pɹɛɡən
inclinable	ɪn.'klaɪ.nʌ.bʌ
forborn	'fɔː.bɔː
unsuspect	ʌn.sʌ.'spɛk
ingorged	ɪn.'ɡɔːdʒ
infamed	'ɪn.fʌm
dieted	'daɪ.ʌ.tɪ
openest	'əʊ.pʌ.nʌs
givest	'ɡɪ.vɛs
forbidder	fʌ.'bɪ.dʌ
sciential	'saɪ.ʌn.ʃʌ
reapers	'ɹi.pʌ
misgave	mɪs.'ɡeɪ
ampler	'æm.plʌ
unshared	ʌn.'ʃəː
astonied	æ.'stɑ.nɪ
deflowered	dɪ.'flaʊ.ʌ
forbiddance	fʌ.'bɪ.dʌn
recomforted	`ɹi.'kʌm.fʌ.tɪ
remediless	'ɹɛ.mʌ.`di.lʌ
coveting	'kʌ.vɪ.tɪŋ
foretasted	'fɔː.teɪ.stɪ
unhallowed	ʌn.'hæ.ləʊ
dependant	dɪ.'pɛn.dʌn
favours	'feɪ.vʌ
menaced	'mɛ.nɪs
unequalled	ʌ.'ni.kwʌl
ennobled	ɛ.'nəʊ.bʌl
scrupled	'skɹʉː.pʌl
loured	'ləː
iterate	'ɪ.tʌ.`ɹeɪ
sooth	'sʉːð
savour	'seɪ.vʌ
purveyed	'pəː.veɪ
imbowered	ɪm.'baʊ.ʌ
asphodel	æ.'sfəʊ.dʌ
danite	'dæ.naɪ
philistean	'fɪ.lɪ.`steɪ.ʌ
dalilah	'dæ.laɪ.lʌ
strucken	'stɹʌ.kʌ
concupiscence	kɑn.kjʉː.'pɪ.sʌn
insufferably	ɪn.'sʌ.fʌ.ɹʌ.blɪ
unseemliest	ʌn.'sim.li.ʌs
girded	'ɡəː.dɪ
malabar	'mæ.læ.`bɑ
decan	dɪ.'kæ
herdsman	'həːdz.mʌ
targe	'tɑdʒ
cincture	'sɪŋk.tʃʌ
hearkened	'hɑ.kʌn
imputest	ɪm.'pjʉː.tʌs
joyed	'dʒɔɪ
overtrusting	`əʊ.vʌ.'tɹʌ.stɪŋ
despiteful	dɪ.'spaɪt.fʌ
sincerest	sɪn.'seɪ.ʌ.ɹʌs
inclining	ɪn.'klaɪ.nɪŋ
acquittance	æ.'kwɪ.tʌn
vicegerent	'vaɪsdʒ.ɹʌn
redeemer	ɹɪ.'di.mʌ
unclouded	ʌn.'klaʊ.dɪ
transgressours	tɹæns.'ɡɹɛ.sʌ
ministrant	'mɪ.nɪ.stɹʌn
detains	dɪ.'teɪn
vitiated	'vɪ.ʃɪ.`eɪ.tɪ
unbid	ʌn.'bɪ
nakedness	'neɪ.kɪd.nʌ
counterview	'kaʊn.tʌ.`vjʉː
avengers	æ.'vɛn.dʒʌ
connatural	kʌ.'næ.tʃʌ.ɹʌ
secretest	'sɛ.kɹɛ.tʌs
unagreeable	ʌ.næ.'ɡɹi.ʌ.bʌ
transmigration	tɹæn.smɪ.'ɡɹeɪ.ʃʌ
enterprisest	'ɛn.tʌ.`pɹaɪ.sʌs
upturned	'ʌp.təːn
sagacious	sæ.'ɡeɪ.ʃʌ
crouded	'kɹaʊ.dɪ
shoaling	'ʃəʊ.lɪŋ
cronian	'kɹəʊ.neɪ.ʌ
petsora	'pɛt.sɔː.ɹʌ
cathaian	'kæ.taɪ.ʌ
petrifick	'pɛ.tɹɪ.`fɪ
rigour	'ɹɪ.ɡʌ
asphaltick	'æ.sfæl.`tɪ
immoveable	ɪ.'mʉː.vʌ.bʌ
memnonian	mɛm.'nəʊ.neɪ.ʌ
hellespont	'hɛ.lɪ.`spɑn
scourged	'skəːdʒ
unminded	ʌn.'maɪn.dɪ
unweeting	ʌn.'wi.tɪŋ
covertures	'kʌ.vʌ.tʃʌ
plaint	'pleɪn
pontifice	'pɑn.tɪ.fɪ
unhoped	ʌn.'həʊp
encreased	ɛn.'kɹis
viewest	'vjʉː.ʌs
divined	dɪ.'vaɪn
connexion	kʌ.'nɛk.ʃʌ
unvoyageable	ʌn.'vɔɪ.ɪ.dʒʌ.bʌ
impowered	ɪm.'paʊ.ʌ
builded	'bɪl.dɪ
quadrature	'kwɑ.dɹʌ.tʃʌ
plenipotent	'plɛ.nɪ.`pəʊ.tʌn
paragoned	'pæ.ɹʌ.ɡʌn
emperour	'ɛm.pʌ.ɹʌ
astracan	æ.'stɹæ.kʌ
bactrin	'bæk.tɹɪ
sophi	'sɑ.faɪ
aladule	æ.'læd.jʉː
tauris	'tɔː.ɹɪ
casbeen	'kæs.bi
fulgent	'fʊəl.dʒʌn
congratulant	kʌn.'ɡɹæt.jʊə.lʌn
untractable	ʌn.'tɹæk.tʌ.bʌ
unoriginal	ʌ.nʌ.'ɹɪ.dʒɪ.nʌ
clamorous	'klæ.mʌ.ɹʌ
thereat	ðəː.'ɹæ
entwining	ɛn.'twaɪ.nɪŋ
amphisbaena	'æm.fɪs.`bi.nʌ
cerastes	'sɛ.ɹɑst
hydrus	'haɪ.dɹʌ
elops	ɪ.'lɑp
drear	'dɹeɪ.ʌ.ʌ
dipsas	'dɪp.sʌ
bedropt	'bɛ.dɹɑp
ophiusa	'ɑ.fɪ.ʌ.sʌ
ingendered	ɪn.'dʒɛn.dʌ
catched	'kætʃ
megaera	'mɛ.ɡʌ.ɹʌ.ɹʌ
hatefullest	'heɪt.fʊə.lʌs
ophion	'ɑ.feɪ.ʌ
eurynome	'jʉː.ɹɪ.`nəʊ
dictaean	dɪk.'teɪ.ʌ
undreaded	ʌn.'dɹɛ.dɪ
unhide	ʌn.'haɪ
incestuous	ɪn.'sɛs.tʃʉː.ʌ
unspared	ʌn.'spəː
unimmortal	`ʌ.nɪ.'mɔː.tʌ
draff	'dɹæ
gorged	'ɡɔːdʒ
offal	'ɑ.fʌ
halleluiah	`hæ.lɪ.'lʉː.jʌ
solstitial	'sɑl.stɪ.ʃʌ
sextile	'sɛk.staɪ
unbenign	ʌn.bɪ.'naɪ
ascanse	æ.'skæn
tropick	'tɹɑ.pɪ
vernant	'vəː.nʌn
unbenighted	ʌn.bɪ.'naɪ.tɪ
estotiland	'ɛ.stʌ.`tɪ.lʌn
thyestean	'θaɪ.ɪ.`steɪ.ʌ
sideral	'saɪ.dʌ.ɹʌ
pestilent	'pɛ.stɪ.lʌn
norumbega	'nɔː.ɹʌm.bɪ.ɡʌ
samoed	'sæ.məʊ
boreas	bɔː.'ɹeɪ.ʌ
caecias	'ki.ʃʌ
argestes	'ɑ.dʒɛst
thrascias	'θɹæ.seɪ.ʌ
notus	'nəʊ.tʌ
afer	æ.'fəː
serraliona	`sɛ.ɹæ.lɪ.'əʊ.nʌ
ponent	'pəʊ.nʌn
eurus	'jʉː.ɹʌ
sirocco	sɪ.'ɹɑ.kəʊ
libecchio	'laɪb.kɪ.`əʊ
gloomiest	'ɡlʉː.mɪ.ʌs
deservings	dɪ.'zəː.vɪŋ
execration	ɛɡ.zɪ.'kɹeɪ.ʃʌ
reflux	'ɹi.flʌk
cavil	'kæ.vʌ
reproved	ɹɪ.'pɹʉːv
overlive	`əʊ.vʌ.'laɪ
deathless	'dɛθ.lʌ
clod	'klɑ
anger's	'æŋ.ɡʌ
bereaving	bɪ.'ɹi.vɪŋ
defenceless	dɪ.'fɛn.slʌ
disinherited	`dɪ.sɪn.'hɛ.ɹɪ.tɪ
reasonings	'ɹi.zʌ.nɪŋ
desirest	dɪ.'zaɪ.ʌ.ɹʌs
horrours	'hɑ.ɹʌ
mends	'mɛnd
leagued	'liɡ
forewarning	fɔː.'wɔː.nɪŋ
overweening	`əʊ.vʌ.'wi.nɪŋ
supernumerary	`sʉː.pʌn.'jʉː.mʌ.ɹʌ.ɹi
betake	bɪ.'teɪ
commiseration	kʌ.`mɪ.sʌ.'ɹeɪ.ʃʌ
upraised	ʌ.'pɹeɪz
feelest	'fi.lʌs
bearest	'bəː.ɹʌs
infirmer	ɪn.'fəː.mʌ
unbegot	ʌn.bɪ.'ɡɑ
contemns	kʌn.'tɛm
overloved	`əʊ.vʌ.'lʌv
wiselier	'waɪ.sli.ʌ
contumacy	kʌnt.'jʉː.mʌ.si
piteous	'pɪ.teɪ.ʌ
shal	'ʃæ
wilful	'wɪl.fʌ
barrenness	'bæ.ɹʌn.nʌ
savours	'seɪ.vʌ
reviling	ɹɪ.'vaɪ.lɪŋ
recompensed	'ɹɛ.kʌm.`pɛns
aslope	æ.'sləʊ
unbesought	ʌn.bɪ.'sɔː
benummed	bɪ.'nʌm
attrite	æ.'tɹaɪ
kindles	'kɪn.dʌl
commodiously	kʌ.'məʊ.dɪ.ʌ.sli
frequenting	'fɹi.kwʌn.tɪŋ
lowliest	'ləʊ.li.ʌs
prevenient	pɹɪ.'vi.nɪ.ʌn
unutterable	ʌ.'nʌ.tʌ.ɹʌ.bʌ
deucalion	djʉː.'kæ.leɪ.ʌ
pyrrha	'pɪɹ.hʌ
themis	'θi.mi
dimensionless	daɪ.'mɛn.ʃʌn.lʌ
unskilful	ʌn.'skɪl.fʌ
propitiation	pɹʌ.`pɪ.tɪ.'eɪ.ʃʌ
ingraft	ɪn.'ɡɹɑf
unharmonious	ʌn.hɑ.'məʊ.nɪ.ʌ
incorrupt	ɪn.kʌ.'ɹʌp
peccant	'pɛ.kʌn
blisful	'blɪz.fʌ
amarantine	'æ.mʌ.`ɹæn.ti
where'er	'wəː.ɹʌ
repents	ɹɪ.'pɛnt
bewailing	bɪ.'weɪ.lɪŋ
disconsolate	dɪ.'skɑn.sʌ.lʌ
sorrowing	'sɑ.ɹəʊ.ɪŋ
drouse	'dɹaʊ
leucothea	'lʉː.kʌ.`θeɪ.ʌ
imbalmed	ɪm.'bɑm
kneeled	'nil
placable	'pleɪ.kʌ.bʌ
transgressour	tɹæns.'ɡɹɛ.sʌ
vouchsaf'st	'vaʊtʃ.sæfs
gayest	'ɡeɪ.ʌs
mahanaim	'mæ.hæ.`neɪ
pavilioned	pæ.'vɪ.leɪ.ʌn
unproclaimed	ʌn.pɹʌ.'kleɪm
visitant	'vɪ.zɪ.tʌn
sociably	'səʊ.ʃeɪ.ʌ.bli
meliboean	'mɛ.lɪ.`bəʊ.ʌ
unbuckled	ʌn.'bʌ.kʌl
zodiack	'zəʊ.dɪ.`æ
satan's	'seɪ.tʌn
seisure	'seɪ.ʒʌ
dejection	dɪ.'dʒɛk.ʃʌ
sinfulness	'sɪn.fʌl.nʌ
wakest	'weɪ.kʌs
sleptst	'slɛpts
leadest	'li.dʌs
chastening	'tʃeɪ.stʌ.nɪŋ
amplest	'æm.plʌs
cambalu	kæm.'bɑ.lʉː
samarchand	'sæ.mɑ.`tʃæn
oxus	'ɑk.sʌ
temir's	'tɛ.meɪ.ʌ.ʌ
sinaean	sɪ.'neɪ.ʌ
lahor	'læ.hʌ
chersonese	`tʃəː.səʊ.'ni
ecbatan	'ɛk.bæ.tʌ
hispahan	'hɪ.spæ.`hæ
ksar	'keɪ.'sɑ
bizance	'bɪ.zʌn
turchestan	'təː.tʃɪ.`stæ
ercoco	əː.'kəʊ.kəʊ
maritim	'mæ.ɹɪ.tɪ
mombaza	mʌm.'bɑ.zʌ
quiloa	kwɪ.'ləʊ.ʌ
melind	'mɛ.lɪn
sofala	səʊ.'fɑ.lʌ
ophir	'ɑ.feɪ.ʌ.ʌ
almansor	'ɑl.mæn.sʌ
tremisen	'tɹɛ.maɪ.sʌ
montezume	'mɑn.tɪz.`jʉː
cusco	'kʌ.skəʊ
atabalipa	'æ.tæ.`bæ.lɪ.pʌ
geryon's	dʒʌ.'jɑn
euphrasy	'jʉː.fɹʌ.si
ope	'əʊ
rustick	'ɹʌ.stɪ
sord	'sɔː
tillage	'tɪ.lɪdʒ
unculled	ʌn.'kʌl
firstlings	'fəː.slɪŋ
inwards	'ɪn.wʌd
strowed	'stɹəʊ
inly	'ɪn.li
midriff	'mɪ.dɹɪ
effused	ɪ.'fjʉːz
intemperance	ɪn.'tɛm.pʌ.ɹʌn
inabstinence	ɪ.'næb.stɪ.nʌn
noisome	'nɔɪ.sʌ
feverous	'fi.vʌ.ɹʌ
catarrhs	kʌ.'tɑ
colick	'kɑ.lɪ
demoniack	di.'məʊ.nɪ.`æ
phrenzy	'fɹɛn.zi
moaping	'məʊ.pɪŋ
marasmus	'mæ.ɹæz.mʌ
dropsies	'dɹɑp.sɪ
asthmas	'æ.smʌ
rheums	'ɹʉːm
obtruded	ɑb.'tɹʉː.dɪ
ungoverned	ʌn.'ɡʌ.vʌn
inductive	ɪn.'dʌk.tɪ
worthily	'wəː.ðɪ.lɪ
drinkest	'dɹɪŋ.kʌs
livest	'laɪvs
volant	'vɑ.lʌn
fusil	'fjʉː.sʌ
inventers	ɪn.'vɛn.tʌ
appetence	æ.'pɛ.tʌn
ignobly	ɪɡ.'nɑ.bli
erelong	ɪ.'ɹɛ.lɑŋ
tenour	'tɛ.nʌ
beeves	'biv
pastured	'pɑs.tʃʌ
ensanguined	ɛn.'sæŋ.ɡwaɪn
gigantick	'ɡɪ.ɡʌn.`tɪ
sceptered	'sɛp.tʌ
factious	'fæk.ʃʌ
inhumanly	ɪn.'hjʉː.mʌn.li
thousandfold	'θaʊ.zʌnd.`fəʊl
conquerours	'kɑn.kwʌ.ɹʌ
rightlier	'ɹaɪt.li.ʌ
beheldst	bɪ.'hɛlds
preverse	pɹɪ.'vəː
jollity	'dʒɑ.lɪ.ti
prostituting	'pɹɑ.stɪt.`jʉː.tɪŋ
whereso	'wəː.səʊ
beaked	'bik
whelped	'wɛlp
stabled	'steɪ.bʌl
imbarked	ɪm.'bɑk
comfortless	'kʌm.fʌt.lʌ
utter'dst	'ʌ.tʌds
foreknowing	'fɔː.`nəʊ.ɪŋ
wantonness	'wɑn.tʌn.nʌ
dissolute	'dɪ.sʌ.`lʉː
allurement	æ.'lʊə.mʌn
impenitence	ɪm.'pɛ.nɪ.tʌn
orcs	'ɔːk
mews	'mjʉː
stopt	'stɑp
sluces	'slʉː.sɪ
pacifick	'pæ.sɪ.`fɪ
betokening	bɪ.'təʊk.nɪŋ
vouchsafes	'vaʊtʃ.seɪf
dextrously	'dɛk.stɹʌ.sli
aimest	'eɪ.mʌs
relents	ɹɪ.'lɛnt
xii	`ɹəʊ.mʌn.'twɛl
unblamed	ʌn.'bleɪm
tyrannous	'tɪ.ɹæ.nʌ
sovranty	'sɑv.ɹʌn.ti
tyrannize	'tɪ.ɹæ.`naɪ
gurge	'ɡəːdʒ
jangling	'dʒæŋ.ɡʌ.lɪŋ
gabble	'ɡæ.bʌ
usurper	jʉː.'zəː.pʌ
famish	'fæ.mɪʃ
abhorrest	æb.'hɑ.ɹɛs
twinned	'twɪn
undeservedly	`ʌn.dɪ.'zəː.vɪd.lɪ
iniquities	ɪ.'nɪ.kwɪ.ti
chaldaea	tʃæl.'deɪ.ʌ
sechem	'sɛ.kʌ
moreh	'mɔː
hameth	'heɪ.mʌθ
founted	'faʊn.tɪ
senir	'si.neɪ.ʌ.ʌ
plainlier	'pleɪn.li.ʌ
overgrowth	`əʊ.vʌ.'ɡɹəʊθ
inhospitably	ɪn.'hɑ.spɪ.tʌ.blɪ
enthralment	ɛn.'θɹɔːl.mʌn
unshed	ʌn.'ʃɛ
botches	'bɑ.tʃɪ
blains	'bleɪn
inexpert	`ɪ.'nɛk.spəː
rashness	'ɹæʃ.nʌ
appertain	æ.'pəː.teɪ
beseech	bɪ.'sitʃ
foretel	'fɔː.tʌ
prescript	pɹɪ.'skɹɪp
gibeon	'dʒaɪ.bɑ
aialon	'eɪ.æ.lʌ
enlightener	ɛn.'laɪ.ti.nʌ
unmerited	ʌn.'mɛ.ɹɪ.tɪ
pravity	'pɹæ.vɪ.ti
expiations	ɛk.spɪ.'eɪ.ʃʌn
stablished	'stæ.blɪʃ
dissention	dɪ.'sɛn.ʃʌ
squadroned	'skwɑ.dɹʌn
dewed	'djʉː
steadiest	'stɛ.dɪ.ʌs
recure	ɹɪ.'kjʊə
appaid	æ.'peɪ
reproachful	ɹɪ.'pɹəʊtʃ.fʌ
blasphemed	blɑ.'sfim
annuls	æ.'nʌl
shouldest	'ʃʊə.dʌs
baptizing	'bæp.taɪ.zɪŋ
profluent	'pɹɑ.flʉː.ʌn
abraham's	'eɪ.bɹʌ.`hæm
endue	ɛnd.'jʉː
lucre	'lʉː.kʌ
inrolled	'ɪn.ɹəʊl
bestuck	bɪ.'stʌ
obscurely	ɑb.'skjʊə.li
conflagrant	kʌn.'fleɪ.ɡɹʌn
truth's	'tɹʉːθ
knewest	'njʉː.ʌs
enjoyedst	ɛn.'dʒɔɪ.ɛds
wentest	'wɛn.tʌs
meteorous	'mi.tɪ.ʌ.ɹʌ
labourer's	'leɪ.bəː.ɹʌ
adust	æ.'dʌs
am'rous	'æm.ɹʌ
sing——this	'sɪŋ.'ðɪ
ev'n	'ɛv
t'assault	'ti.'æ.sɑl
bosoms	'bʊə.sʌm
thro	'θɹəʊ
giv'n	'dʒɪv
rowsing	'ɹəʊ.zɪŋ
prepar'd	pɹɪ.'pɑ
sylph	'sɪl
glitt'ring	'ɡlɪ.tɹɪŋ
caus'd	'kaʊs
e'er	'əː
pow'rs	'paʊɹ
heav'nly	'hivən.li
flow'rs	'fləʊɹ
unnumber'd	ʌn.'nʌm.bʌ
inclos'd	ɪn.'klɑz
o'erlooks	'ɔː.lʊək
ombre	'ɑm.bʌ
sprights	'spɹaɪt
termagants	'təː.mæ.ɡʌnt
salamander's	'sæ.læ.`mɑn.dʌ
gnome	'nəʊ
coquettes	kʌ.'kɛt
sylphs	'sɪlf
embrac'd	ɛm.'bɹæk
masquerades	'mæ.skwʌ.`ɹeɪd
treach'rous	'tɹitʃ.ɹʌ
celestials	sʌ.'lɛst.jʌl
predestin'd	pɹɪ.'dɛ.stɪn
bidden	'bɪ.dʌ
ev'ry	'ɛv.ɹi
toyshop	'tɔɪ.ʃɑ
beaus	'bəʊ
e're	'i.ʌ
wak'd	'wæk
doux	'dʉː
ardors	'ɑ.dɔː
altar's	'ɑl.tʌ
off'rings	'ɑ.fɹɪŋ
culls	'kʌl
unlocks	ʌn.'lɑk
plait	'pleɪ
prais'd	'pɹeɪz
etherial	i.'θeɪ.ʌ.ɹɪ.ʌ
purpled	'pəː.pʌl
lanch'd	'lɑntʃ
drest	'dɹɛs
fixt	'fɪks
2	'tʉː
lud	'lʌ
guernier	'ɡəː.nɪ.ʌ
inv	'ɪn
boſc	'bɑs
sculp	'skʌl
unfix'd	ʌn.'fɪks
gazers	'ɡeɪ.zʌ
conspir'd	kʌn.'speɪ.ʌ.ʌ
iv'ry	'ɪv.ɹi
labyrinths	'læ.bʌ.`ɹɪnθ
sprindges	'spɹɪn.dʒɪ
surprize	sʌ.'pɹaɪ
finny	'fɪ.ni
insnare	ɪn.'snəː
adventrous	'æd.vɛn.tɹʌ
admir'd	æd.'meɪ.ʌ.ʌ
aspir'd	'æ.speɪ.ʌ.ʌ
resolv'd	ɹɪ.'zɑlv
meditates	'mɛ.dɪ.`teɪt
ravish	'ɹæ.vɪʃ
phœbus	'fəʊ.bʌ
implor'd	ɪm.'plɔː
pow'r	'paʊ
love——to	'lʌv.'tʉː
flavia's	'flæ.vi.ʌ
pyre	'paɪ.ʌ
pray'r	'pɹeɪ
dispers'd	dɪ.'spəːz
tydes	'taɪd
smil'd	'smɪl
sylph——with	'sɪlf.'wɪð
opprest	ʌ.'pɹɛs
dissolv'd	dɪ.'sɑlv
filmy	'fɪl.mi
disports	dɪ.'spɔːt
whene'er	'wɛ.nəː
pinions	'pɪ.neɪ.ʌn
rais'd	'ɹeɪz
sylphids	'sɪl.fɪd
fays	'feɪ
genii	'dʒi.nɪ.`aɪ
dæmons	'dæ.mʌn
æther	'æ.ðʌ
wandring	'wɑn.dɹɪŋ
refin'd	ɹɪ.'fɪn
tempests	'tɛm.pʌst
glebe	'ɡli
show'rs	'ʃəʊɹ
furbelo	fəː.'bi.ləʊ
deserv'd	dɪ.'zəːv
spirit's	'spɪ.ɹɪt
pray'rs	'pɹeɪɹ
flutt'ring	'flʌ.tɹɪŋ
zephyretta's	`zɛ.fɪ.'ɹɛ.tʌ
brillante	bɹɪ.'lɑn.teɪ
momentilla	`məʊ.mɪn.'tɪ.lʌ
crispissa	kɹɪ.'spɪ.sʌ
fav'rite	'fæv.ɹaɪ
sev'nfold	'sɛvən.fəʊl
o'ertake	'ɔː.teɪ
transfixt	tɹæn.'sfɪks
plung'd	'plʌŋ
wedg'd	'wɛdʒ
bodkin's	'bɑd.kɪn
pomatums	pʌ.'meɪ.tʌm
silken	'sɪl.kʌ
alom	æ.'lɑ
stypticks	'staɪp.tɪk
rivell'd	'ɹɪ.vɛl
wretch	'ɹɛtʃ
froaths	'fɹəʊθ
thrid	'θɹɪ
pendants	'pɛn.dʌnt
3	'θɹi
tow'rs	'təʊɹ
neighb'ring	'neɪ.bɹɪŋ
foredoom	'fɔː.dʉː
take—and	'teɪ.kæn
ogling	'ɑ.ɡlɪŋ
wretches	'ɹɛ.tʃɪ
toilette	tɔɪ.'lɛ
matadore	'mæ.tæ.`dɔː
rever'd	ɹɪ.'veɪ.ʌ.ʌ
forky	'fɔː.ki
flow'r	'fləʊ
garbs	'ɡɑb
halberds	'hæl.bəːd
particolour'd	'pɑ.tɪ.`kʌ.lʌ
matadores	'mæ.tæ.`dɔː
spadillio	spæ.'dɪ.lɪ.`əʊ
manillio	mæ.'nɪ.lɪ.`əʊ
forc'd	'fɔːk
basto	'bɑ.stəʊ
o'erthrow	'ɔː.θɹəʊ
undistinguish'd	ʌn.dɪ.'stɪŋ.ɡwɪʃ
dy'd	'daɪ
barb'rous	'bɑ.bɹʌ
combin'd	kʌm.'bɪn
easie	'i.zi
africk's	'æ.fɹɪk
pierc'd	'peɪ.ʌ.ʌk
o'erwhelms	'ɔː.wɛlm
paleness	'peɪl.nʌ
trembles	'tɹɛm.bʌl
codille	'kɑ.dɪ
gen'ral	'dʒɛn.ɹʌ
exulting	ɛɡ.'zʌl.tɪŋ
curs'd	'kəːz
tyde	'taɪ
1]scylla's	'wɑn.'saɪ.lʌ
nisus	'nɪ.sʌ
injur'd	'ɪn.dʒəː
edg'd	'ɛdʒ
rev'rence	ɹɪv.'ɹɛn
finger's	'fɪŋ.ɡʌ
belinda's	bɪ.'lɪn.dʌ
nosegay	'nəʊs.ɡeɪ
reclin'd	ɹɪ.'klɪn
amaz'd	æ.'meɪz
confus'd	kʌn.'fʌz
expir'd	ɛk.'speɪ.ʌ.ʌ
retir'd	ɹɪ.'teɪ.ʌ.ʌ
forfex	'fɔː.fɛk
t'inclose	'ti.'ɪŋ.kləʊ
interpos'd	`ɪn.tʌ.'pɑs
urg'd	'əːɡ
sheers	'ʃeɪ.ʌ.ʌ
2]but	'tʉː.`bʌ
dissever	dɪ.'sɛ.vʌ
fal'n	'fæl
glittring	'ɡlɪ.tɹɪŋ
atalantis	'æ.tæ.`lɑn.ti
assignations	æ.sɪɡ.'neɪ.ʃʌn
wou'd	'wʉː
shou'd	'ʃʉː
conqu'ring	kɑnkw.'ɹɪŋ
unresisted	`ʌn.ɹɪ.'sɪ.stɪ
ovid	'əʊ.vɪ
metam	'mɛ.tæ
8	'eɪ
6	'sɪk
battel	'bæ.tʌ
seiz'd	'siz
refus'd	ɹɪ.'fʌz
unrepenting	`ʌn.ɹɪ.'pɛn.tɪŋ
manteau's	'mɑn.təʊ
4	'fɔː
umbriel	'ʌm.bɹi.ʌ
spright	'spɹaɪ
flitts	'flɪt
sheltred	'ʃɛl.tʌ
clsse	`si.`ɛ.'lɛ.`sɛ.'si
languor	'læŋ.ɡjʉː.ʌ
handmaids	'hænd.meɪd
diff'ring	'dɪ.fɹɪŋ
lampoons	læm.'pʉːn
practis'd	'pɹæk.tɪz
faints	'feɪnt
hermit's	'həː.mɪt
spectres	'spɛk.tʌ
teapots	'ti.pɑt
pow'rful	'paʊɹ.fʌ
bottels	'bɑ.tʌl
fantastick	'fɑn.tæ.`stɪ
spleenwort	'splin.wɔː
addrest	æ.'dɹɛs
pow'r——hail	'paʊɹ.'heɪ
physick	'fɪ.zɪ
matron's	'meɪ.tɹʌn
discompos'd	dɪ.'skɑm.pɑz
costive	'kɑ.stɪ
griefs	'ɡɹif
thalestris	'θeɪl.stɹɪ
ecchos	'ɛ.kəʊ
tort'ring	'tɔː.tɹɪŋ
ravisher	'ɹæ.vɪ.ʃʌ
fops	'fɑp
unrival'd	ʌn.'ɹaɪ.vʌl
inestimable	ɪ.'nɛ.stɪ.mʌ.bʌ
monkies	'mʌn.ki
ds	`di.'ɛ
on't	'ɑn
prithee	'pɹɪ.θi
1	'wɑ
clipt	'klɪp
forbears	'fɔː.bəː
heav'd	'hiv
num'rous	'nʌm.ɹʌ
bohea	'bəʊ.heɪ.ʌ
desarts	dɪ.'sɑt
mov'd	'mɑv
tott'ring	'tɑ.tɹɪŋ
believ'd	bɪ.'liv
snowie	'snəʊ.i
uncurl'd	ʌn.'kəːl
achilles's	æ.'kɪ.li.zɪ
stopp'd	'stɑp
combate	'kɑm.beɪ
russle	'ɹʌ.sʌ
walebones	'weɪl.bəʊn
heroins	'hɛ.ɹəʊ.`ɪn
confus'dly	kʌn.'fʌsd.li
gainst	'ɡeɪns
deeps	'dip
sconce's	'skɑn.sɪ
clapt	'klæp
propt	'pɹɑp
enrag'd	ɛn.'ɹæɡ
thalestries	'θeɪl.stɹɪ
scatters	'skæ.tʌ
witling	'wɪt.lɪŋ
dapperwit	'dæ.pʌ.`wɪ
fopling	'fɑ.plɪŋ
2]those	'tʉː.'ðəʊ
killing——was	'kɪ.lɪŋ.'wɑ
meander's	mi.'æn.dʌ
flow'ry	'fləʊ.ɹi
reviv'd	ɹɪ.'vaɪv
indu'd	ɪn.'dʉː
subdu'd	'sʌb.dʉː
atome	'æ.təʊ
o'erflows	'ɔː.fləʊ
ecchoes	'ɛ.kəʊ
incens'd	'ɪn.sʌnz
vigaro	vɪ.'ɡæ.ɹəʊ
4]the	'fɔː.ðʌ
personage	'pəː.sʌ.nɪdʒ
grandsire	'ɡɹænd.saɪ.ʌ
grandame's	'ɡɹæn.deɪm
gingled	'dʒɪŋ.ɡʌl
grac'd	'ɡɹæk
dejects	dɪ.'dʒɛkt
cupid's	'kjʉː.pɪd
flames,——but	'fleɪmz.'bʌ
5	'faɪ
treasur'd	'tɹɛ.ʒʌ
heroe's	'heɪ.ʌ.ɹəʊ
pondrous	'pɑn.dɹʌ
beau's	'bəʊ
riband	'ɹɪ.bæn
casuistry	'kæ.ʒʉː.`ɪ.stɹi
muse——she	'mjʉːs.'ʃi
heav'ns	'hivən
proculus	'pɹɑ.kjʊə.lʌ
berenice's	bɪ.'ɹɛ.nɪ.sɪ
bespangling	bɪ.'spæŋ.ɡʌ.lɪŋ
rosamonda's	'ɹɑ.sæ.`mɑn.dʌ
galilæo's	ɡæ.'lɪ.laʊ
sett	'sɛ
mid'st	'mɪds
inscribe	ɪn.'skɹaɪ
riper	'ɹaɪ.pʌ
feed'st	'fids
light'st	'laɪts
buriest	'bɛ.ɹɪ.ʌs
churl	'tʃəː
makest	'meɪ.kʌs
niggarding	'nɪ.ɡʌ.dɪŋ
glutton	'ɡlʌ.tʌ
beseige	bɪ.'seɪdʒ
thriftless	'θɹɪft.lʌ
feel'st	'fils
renewest	ɹɪn.'jʉː.ʌs
unbless	'ʌn.blʌ
unear'd	ʌ.'neɪ.ʌ.ʌ
unthrifty	ʌn.'θɹɪf.ti
niggard	'nɪ.ɡʌ
profitless	'pɹɑ.fɪt.lʌ
usurer	'jʉːz.jʊə.ɹʌ
o'ersnow'd	'ɔː.snəʊ
bareness	'bəː.nʌ
happies	'hæ.pɪ
refigured	ɹɪ.'fɪ.ɡʌ
highmost	'haɪ.məʊs
reeleth	'ɹi.lʌθ
unlook'd	ʌn.'lʊək
singleness	'sɪŋ.ɡʌl.nʌ
consumest	kʌn.'sʉː.mʌs
makeless	'meɪ.klʌ
unthrift	ʌn.'θɹɪf
bear'st	'bəːs
unprovident	ʌn.'pɹɑ.vɪ.dʌn
stick'st	'stɪks
ruinate	'ɹʉː.ɪ.`neɪ
growest	'ɡɹəʊ.ʌs
departest	dɪ.'pɑ.tʌs
youngly	'jʌŋ.li
bestowest	bɪ.'stəʊ.ʌs
mayst	'meɪs
convertest	kʌn.'vəː.tʌs
threescore	'θɹi.skɔː
barrenly	'bæ.ɹʌn.li
bristly	'bɹɪst.li
scythe	'saɪð
yourself's	jɔː.'sɛlf
unthrifts	ʌn.'θɹɪft
dearths	'dəːθ
presenteth	pɹɪ.'zɛn.tʌθ
vaunt	'vɔːn
inconstant	ɪn.'kɑn.stʌn
debateth	dɪ.'beɪ.tʌθ
engraft	ɛn.'ɡɹɑf
liker	'laɪ.kʌ
metre	'mi.tʌ
dimm'd	'dɪm
untrimm'd	ʌn.'tɹɪm
owest	'əʊ.ʌs
wander'st	'wɑn.dʌs
gazeth	'ɡeɪ.zʌθ
amazeth	æ.'meɪ.zʌθ
stirr'd	'stəː
couplement	'kʌ.plɪ.mʌn
rondure	'ɹɑnd.jʊə
furrows	'fʌ.ɹəʊ
seemly	'sim.li
raiment	'ɹeɪ.mʌn
unperfect	ʌn.pʌ.'fɛk
strength's	'stɹɛŋθ
o'ercharged	'ɔː.tʃɑdʒ
presagers	'pɹɛ.sɪ.dʒʌ
bosom's	'bʊə.sʌm
favourites	'feɪ.vʌ.ɹɪt
famoused	'feɪ.maʊs
embassage	'ɛm.bʌ.sɪdʒ
soul's	'səʊl
sightless	'saɪt.lʌ
either's	'aɪ.ðʌ
twire	'twaɪ.ʌ
gild'st	'ɡɪlds
grief's	'ɡɹif
beweep	bɪ.'wi
bootless	'bʉːt.lʌ
despising	dɪ.'spaɪ.zɪŋ
dateless	'deɪt.lʌ
cancell'd	'kæn.sɛl
stol'n	'stɑl
outstripp'd	aʊt.'stɹɪp
alack	æ.'læ
disdaineth	dɪs.'deɪ.nʌθ
staineth	'steɪ.nʌθ
physic	'fɪ.zɪ
offender's	ʌ.'fɛn.dʌ
offence's	ʌ.'fɛn.sɪ
salving	'sæl.vɪŋ
accessary	æk.'sɛ.sʌ.ɹi
sourly	'saʊ.ʌ.li
separable	'sɛ.pʌ.ɹʌ.bʌ
bewailed	bɪ.'weɪl
engrafted	ɛn.'ɡɹɑf.tɪ
pour'st	'pɔːs
rhymers	'ɹaɪ.mʌ
invocate	ɪn.'vəʊ.keɪ
deservest	dɪ.'zəː.vɛs
teachest	'ti.tʃʌs
deceivest	dɪ.'si.vɛs
refusest	ɹɪ.'fjʉː.sʌs
hate's	'heɪt
spites	'spaɪt
mightest	'maɪ.tʌs
knowst	'nəʊs
unrespected	`ʌn.ɹɪ.'spɛk.tɪ
shadow's	'ʃæ.dəʊ
unseeing	ʌn.'si.ɪŋ
recured	ɹɪ.'kjʊə
cide	'saɪ
impanneled	ɪm.'pæ.nʌl
moiety	'mɔɪ.ɪ.ti
awakes	æ.'weɪk
thievish	'θi.vɪʃ
uprear	'ʌ.pɹeɪ.ʌ.ʌ
travel's	'tɹæ.vʌl
plods	'plɑd
dully	'dʌ.li
perfect'st	pʌ.'fɛkts
neigh	'neɪ
carcanet	'kɑ.kæ.`nɛ
foison	'fɔɪ.sʌ
unwoo'd	ʌn.'wʉː
unswept	ʌn.'swɛp
besmear'd	bɪ.'smeɪ.ʌ.ʌ
sluttish	'slʌ.tɪʃ
pebbled	'pɛ.bʌl
elipses	ɪ.'lɪp.sɪ
send'st	'sɛnds
possesseth	pʌ.'zɛ.sʌθ
beated	'bi.tɪ
iniquity	ɪ.'nɪ.kwɪ.ti
travell'd	'tɹæ.vɛl
steepy	'sti.pi
outworn	aʊ.'twɔː
wreckful	'ɹɛk.fʌ
guilded	'ɡɪl.dɪ
shamefully	'ʃeɪm.fʌ.lɪ
strumpeted	'stɹʌm.pɪ.tɪ
miscall'd	mɪ.'skɔːl
impiety	ɪm.'paɪ.ʌ.tɪ
excheckr	ɛks.'tʃɛ.kʌ
sepulchres	'sɛ.pʌl.kʌ
churls	'tʃəːl
matcheth	'mæ.tʃʌθ
slander's	'slɑn.dʌ
present'st	pɹɪ.'zɛnts
vilest	'vaɪ.lʌs
fadeth	'feɪ.dʌθ
see'st	'sis
reviewest	ɹɪ.'vjʉː.ʌs
wretch's	'ɹɛ.tʃɪ
enjoyer	ɛn.'dʒɔɪ.ʌ
filching	'fɪl.tʃɪŋ
gluttoning	'ɡlʌ.tʌ.nɪŋ
poesy	'pəʊ.si
learned's	'ləːnd
shallowest	'ʃæ.ləʊ.ʌs
soundless	'saʊnd.lʌ
breathers	'bɹi.ðʌ
attaint	æ.'teɪn
o'erlook	'ɔː.lʊə
immured	ɪ.'mjʊə
dignifies	'dɪɡ.nɪ.`faɪ
unletter'd	ʌn.'lɛ.tʌ
hindmost	'haɪnd.məʊs
inhearse	ɪn.'həː
swerving	'swəː.vɪŋ
attainted	æ.'teɪn.tɪ
lameness	'leɪm.nʌ
scoped	'skəʊp
rearward	'ɹeɪ.ʌ.ʌ.wʌ
many's	'mɛ.ni
eve's	'iv
outbraves	aʊt.'bɹeɪv
sourest	'saʊ.ʌ.ɹʌs
freezings	'fɹi.zɪŋ
wombs	'wʉːm
unfather'd	ʌn.'fɑ.ðʌ
marjoram	'mɑ.dʒɔː.`ɹæ
fearfully	'feɪ.ʌ.ʌ.fʌ.lɪ
forget'st	fʌ.'ɡɛts
spend'st	'spɛnds
resty	ɹɪ.'staɪ
prevent'st	pɹɪ.'vɛnts
for't	'fɔː
merchandized	'məː.tʃæn.`daɪz
esteeming	ɛ.'sti.mɪŋ
philomel	'fɪ.ləʊ.mʌ
burthens	'bəː.ðʌn
unbred	ʌn.'bɹɛ
wights	'waɪt
blazon	'bleɪ.zɑ
prefiguring	pɹɪ.'fɪ.ɡʌ.ɹɪŋ
incertainties	ɪn.'səː.tʌn.tɪ
preposterously	pɹɪ.'pɑ.stʌ.ɹʌ.sli
offences	ʌ.'fɛn.sɪ
blenches	'blɛn.tʃɪ
dyer's	'daɪ.ʌ
abysm	æ.'bɪ.zʌ
adder's	'æ.dʌ
flatterer	'flæ.tʌ.ɹʌ
effectually	ɪ.'fɛk.tʃʉː.ʌ.li
deformed'st	dɪ.'fɔː.mɛds
saith	'seɪθ
cherubins	'tʃɛ.ɹʉː.`bɪn
o,'tis	'əʊ.'tɪ
greeing	'ɡɹi.ɪŋ
sharp'st	'ʃɑps
incertainty	ɪn.'səː.tʌn.ti
sickle's	'sɪ.kʌl
scanted	'skɑn.tɪ
wilfulness	'wɪl.fʌl.nʌ
meetness	'mit.nʌ
limbecks	'lɪm.bɛk
sportive	'spɔː.tɪ
frailer	'fɹeɪ.lʌ
thralled	'θɹɔːl
extern	ɛk.'stəː
thrivers	'θɹɪ.vʌ
oblation	ʌ.'bleɪ.teɪ.ʌ
suborn'd	'sʌ.bɔːn
grow'st	'ɡɹəʊs
goest	'ɡəʊs
quietus	'kwaɪ.ʌ.tʌ
fairing	'fəː.ɹɪŋ
slandering	'slɑn.dʌ.ɹɪŋ
play'st	'pleɪs
sway'st	'sweɪs
judgment's	'dʒʌdʒ.mʌnt
beseem	bɪ.'si
beshrew	bɪ.'ʃɹʉː
is't	'ɪs
sweet'st	'swits
whoe'er	'wəʊ.ʌ
gaol	'dʒeɪ
covetous	'kʌ.vʌ.tʌ
put'st	'pʌts
overplus	`əʊ.vʌ.'plʌ
addeth	'æ.dʌθ
beseechers	bɪ.'si.tʃʌ
transferr'd	tɹæn.'sfəː
untutor'd	ʌnt.'jʉː.tʌ
unlearned	ʌn.'ləːn
need'st	'nids
slanderers	'slɑn.dʌ.ɹʌ
tongue's	'tʌŋ
unsway'd	ʌn.'sweɪ
reproving	ɹɪ.'pɹʉː.vɪŋ
prizing	'pɹaɪ.zɪŋ
runn'st	'ɹʌns
worser	'wəː.sʌ
tempteth	'tɛmp.tʌθ
inheritors	ɪn.'hɛ.ɹɪ.tʌ
servant's	'səː.vʌnt
nurseth	'nəːsθ
madmen's	'mæd.mɛn
censures	'sɛn.ʃʌ
keep'st	'kips
hateth	'heɪ.tʌθ
frown'st	'fɹaʊns
lour'st	'ləːs
insufficiency	ɪn.sʌ.'fɪ.ʃʌn.si
warrantize	'wɑ.ɹɑn.`taɪ
unworthiness	ʌn.'wəː.ðɪ.nʌ
dian's	'daɪ.ʌn
hied	'haɪ
votary	'vɑ.tʌ.ɹi
loafe	'ləʊ
loveroot	'lʌv.ɹʉː
silkthread	'sɪlk.θɹɛ
darkcolored	'dɑk.kʌ.lʌ
procreant	'pɹɑ.kɹin
dimness	'dɪm.nʌ
entretied	ɛn.'tɹɛ.tɪ
vexes	'vɛk.sɪ
acceptation	æk.sɪp.'teɪ.ʃʌ
folks&#8212;or	'fəʊk.'sænd.hæ.'ʃeɪt.'θaʊ.zʌnd.'tʉː.'hʌn.dɹʌ.dʌn.'twɛl.vɔː
exaltations	ɛɡ.zæl.'teɪ.ʃʌn
compassionating	kʌm.'pæ.ʃʌ.nʌ.tɪŋ
impalpable	ɪm.'pæl.pʌ.bʌ
sidecurved	'saɪd.kəːv
mockings	'mɑ.kɪŋ
abase	æ.'beɪ
abased	æ.'beɪs
valved	'vælv
barestript	'bəː.stɹɪp
elderhand	'ɛl.dʌ.`hæn
wormfence	'wəːm.fɛn
remembrancer	ɹɪ.'mɛm.bɹʌn.sʌ
designedly	dɪ.'zaɪ.nɪd.lɪ
someway	'sʌm.weɪ
kanuck	'kæ.nʌ
tuckahoe	'tʌ.kæ.`həʊ
fathomless	'fæ.ðʌm.lʌ
begetters	bɪ.'ɡɛ.tʌ
undrape	ʌn.'dɹeɪ
broadcloth	'bɹɔːd.klɑθ
redfaced	'ɹɛd.feɪs
peeringly	'peɪ.ʌ.ʌ.ɹɪŋ.lɪ
blab	'blæ
sluff	'slʌ
bootsoles	'bʉːt.səʊl
promenaders	'pɹəʊm.neɪ.dʌ
sleighs	'sleɪ
clinking	'klɪŋ.kɪŋ
hurrahs	hʌ.'ɹɑ
curtained	'kəː.tʌn
litter&#8212;the	'lɪ.tʌ.'ænd.hæ.'ʃeɪt.'θaʊ.zʌnd.'tʉː.'hʌn.dɹʌ.dʌn.'twɛlv.ðʌ
crowd&#8212;the	'kɹaʊ.'dænd.hæ.'ʃeɪt.'θaʊ.zʌnd.'tʉː.'hʌn.dɹʌ.dʌn.'twɛlv.ðʌ
sunstruck	'sʌn.stɹʌ
intertinged	`ɪn.tʌ.'tɪndʒ
armfuls	'ɑm.fʌl
reclined	ɹɪ.'klaɪn
crossbeams	'kɹɑs.bim
wisps	'wɪsp
freshkilled	'fɹɛʃ.kɪl
skysails	'skaɪ.seɪl
joyously	'dʒɔɪ.ʌ.sli
boatmen	'bəʊt.mɛ
clamdiggers	'klɑm.dɪ.ɡʌ
trowser	'tɹəʊ.zʌ
trapper	'tɹæ.pʌ
crosslegged	'kɹɑ.slɪ.`ɡɪ
dumbly	'dʌm.li
lounged	'laʊndʒ
woodpile	'wʊəd.paɪ
limpsey	'lɪmp.sɪ
recuperated	ɹɪ.'kjʉː.pʌ.`ɹeɪ.tɪ
firelock	'faɪ.ʌ.lɑ
womanly	'wʊə.mʌn.li
homeliest	'həʊm.li.ʌs
tremblingly	'tɹɛm.bʌ.lɪŋ.lɪ
souse	'saʊ
blacksmiths	'blæk.smɪθ
grimed	'ɡɹaɪm
environ	ɛn.'vaɪ.ɹʌ
strewed	'stɹʉː
overhand	`əʊ.vʌ.'hæn
roll&#8212;overhand	'ɹəʊ.'lænd.hæ.'ʃeɪt.'θaʊ.zʌnd.'tʉː.'hʌn.dɹʌ.dʌn.'twɛl.`vəʊ.vʌ.'hæn
slow&#8212;overhand	'sləʊ.'ænd.hæ.'ʃeɪt.'θaʊ.zʌnd.'tʉː.'hʌn.dɹʌ.dʌn.'twɛl.`vəʊ.vʌ.'hæn
swags	'swæɡ
stoneyard	'stəʊn.jɑ
stringpiece	'stɹɪŋ.pi
hipband	'hɪp.bæn
caresser	kʌ.'ɹɛ.sʌ
slue	'slʉː
trills	'tɹɪl
sharphoofed	'ʃɑ.fʉːf
housesill	'haʊs.sɪ
chickadee	'tʃɪ.kæ.`di
turkeyhen	'təː.kɪ.hʌ
halfspread	'hɑf.spɹɛ
steerers	'steɪ.ʌ.ʌ.ɹʌ
wielders	'wil.dʌ
mauls	'mɔːl
commonest	'kɑ.mʌ.nʌs
adorning	æ.'dɔː.nɪŋ
contralto	kʌn.'tɹæl.təʊ
organloft	'ɔː.ɡæn.`lɑf
foreplane	'fɔː.pleɪ
whaleboat	'weɪl.bəʊ
anatomist's	'æ.næ.tʌ.`mɪst
quadroon	kwɑ.'dɹʉː
woollypates	'wʊə.lɪ.`peɪt
sugarfield	'ʃʊə.ɡʌ.`fil
darkey	'dɑ.kɪ
squaw	'skwɔː
beadbags	'bid.bæɡ
halfshut	'hɑf.ʃʌ
deckhands	'dɛk.hænd
shoregoing	'ʃɔː.ɡəʊ.ɪŋ
skein	'skeɪ
cleanhaired	klin.'həː
parturition	`pɑ.tʃʌ.'ɹɪ.ʃʌ
vancing	'vɑn.sɪŋ
pavingman	'pɛ.vɪŋ.mʌ
twohanded	'tʉː.hæn.dɪ
rammer&#8212;the	'ɹæ.mʌ.'ænd.hæ.'ʃeɪt.'θaʊ.zʌnd.'tʉː.'hʌn.dɹʌ.dʌn.'twɛlv.ðʌ
notebook&#8212;the	'nəʊt.bʊə.'kænd.hæ.'ʃeɪt.'θaʊ.zʌnd.'tʉː.'hʌn.dɹʌ.dʌn.'twɛlv.ðʌ
signpainter	'saɪn.peɪn.tʌ
towpath&#8212;the	'təʊ.pɑ.'θænd.hæ.'ʃeɪt.'θaʊ.zʌnd.'tʉː.'hʌn.dɹʌ.dʌn.'twɛlv.ðʌ
desk&#8212;the	'dɛ.'skænd.hæ.'ʃeɪt.'θaʊ.zʌnd.'tʉː.'hʌn.dɹʌ.dʌn.'twɛlv.ðʌ
baptised&#8212;the	'bæp.taɪz.'dænd.hæ.'ʃeɪt.'θaʊ.zʌnd.'tʉː.'hʌn.dɹʌ.dʌn.'twɛlv.ðʌ
pedlar	'pɛd.lʌ
back&#8212;the	'bæ.'kænd.hæ.'ʃeɪt.'θaʊ.zʌnd.'tʉː.'hʌn.dɹʌ.dʌn.'twɛlv.ðʌ
higgles	'hɪ.ɡʌl
daguerreotype	'deɪ.ɡɹɪ.`ɑ.taɪ
unrumples	ʌn.'ɹʌm.pʌl
minutehand	maɪn.'jʉː.tɪ.`hæn
reclines	ɹɪ.'klaɪn
draggles	'dɹæ.ɡʌl
bobs	'bɑb
pimpled	'pɪm.pʌl
blackguard	'blæk.ɡɑ
missourian	mɪ.'saʊ.ʌ.ɹeɪ.ʌ
train&#8212;he	'tɹeɪ.'nænd.hæ.'ʃeɪt.'θaʊ.zʌnd.'tʉː.'hʌn.dɹʌ.dʌn.'twɛlv.hi
jingling	'dʒɪŋ.ɡʌ.lɪŋ
floormen	'flɔː.mɛ
floor&#8212;the	'flɔː.'ænd.hæ.'ʃeɪt.'θaʊ.zʌnd.'tʉː.'hʌn.dɹʌ.dʌn.'twɛlv.ðʌ
tinners	'tɪ.nʌ
tinning	'tɪ.nɪŋ
roof&#8212;the	'ɹʉː.'fænd.hæ.'ʃeɪt.'θaʊ.zʌnd.'tʉː.'hʌn.dɹʌ.dʌn.'twɛlv.ðʌ
hod	'hɑ
plougher	'plaʊ.ʌ
ploughs	'plaʊ
wintergrain	'wɪn.tʌ.`ɡɹeɪ
pikefisher	'paɪk.fɪ.ʃʌ
flatboatmen	'flæt.bəʊt.`mɛ
pekantrees	'pɛ.kɑn.`tɹi
altamahaw	'ɔːl.tæ.`mæ.hɔː
regardful	ɹɪ.'ɡɑd.fʌ
nations&#8212	'neɪ.ʃʌn.'zænd.hæ.'ʃeɪt.'θaʊ.zʌnd.'tʉː.'hʌn.dɹʌ.dʌn.'twɛl
limberest	'lɪm.bʌ.ɹʌs
sandhills	'sænd.hɪl
snowshoes	'snəʊ.ʃʉː
foundland	'faʊnd.lʌn
iceboats	'aɪs.bəʊt
northwesterners	nɔː.'θwɛ.stʌ.nʌ
raftsmen	'ɹɑft.smɛ
coalmen&#8212;comrade	'kəʊl.mɛ.'nænd.hæ.'ʃeɪt.'θaʊ.zʌnd.'tʉː.'hʌn.dɹʌ.dʌn.'twɛlv.'kɑm.ɹeɪ
thoughtfulest	'θɔːt.fjʊə.lʌs
experient	ɛk.'speɪ.ʌ.ɹɪ.ʌn
fisheggs	'fɪ.ʃɛɡ
untying	ʌn.'taɪ.ɪŋ
behaviour	bɪ.'heɪ.vjʌ
savans	'sæ.væn
cornets	'kɔː.nɪt
embouchures	ɛm.'baʊʃ.jʊə
keptwoman	'kɛp.twʊə.mʌ
sponger	'spʌn.dʒʌ
venerealee	vɛ.'neɪ.ʌ.ɹɪ.ʌ.`li
redstart	'ɹɛd.stɑ
twittering	'twɪ.tʌ.ɹɪŋ
snivel	'snɪ.vʌ
crape	'kɹeɪ
truckling	'tɹʌ.klɪŋ
ceremonious	`sɛ.ɹɪ.'məʊ.nɪ.ʌ
barleycorn	'bɑ.lɪ.`kɔː
carlacue	'kɑ.læ.`kjʉː
cheerfulness	'tʃeɪ.ʌ.ʌ.fʌl.nʌ
tenoned	'tɛ.nɑn
mortised	'mɔː.taɪz
developement	dɪ.'vɛ.lʌp.mʌn
outstript	aʊt.'stɹɪp
barebosomed	'bəː.bɑ.sʌm
coolbreathed	'kʉːl.bɹið
topt	'tɑp
limpid	'lɪm.pɪ
billowy	'bɪ.ləʊ.i
drowse	'dɹaʊ
unshovelled	ʌn.'ʃʌ.vʌl
partaker	'pɑ.teɪ.kʌ
extoler	ɛk.'stəʊ.lʌ
amies	'eɪ.mi
edness	'ɛd.nʌ
foofoos	'fʉː.fʉː
faultfinder's	'fɑlt.faɪn.dʌ
rejecter's	ɹɪ.'dʒɛk.tʌ
scrofula	'skɹɑ.fjʊə.lʌ
decillions	dɛ.'sɪ.leɪ.ʌn
henceforward	`hɛn.sɪ.'fɔː.wʌ
imbueing	ɪm.'bjʉː.ɪŋ
stonecrop	'stəʊn.kɹɑ
cartouches	'kɑ.tʌ.tʃɪ
neuters	'njʉː.tʌ
geldings	'ɡɛl.dɪŋ
roughs	'ɹʌf
kosmos	'kɑz.məʊ
sentimentalist	`sɛn.tɪ.'mɛn.tʌ.`lɪs
immodest	ɪ.'mɑ.dʌs
unscrew	ʌn.'skɹʉː
jambs	'dʒæm
afflatus	æ.'flæ.tʌ
stars&#8212;and	'stɑ.'zænd.hæ.'ʃeɪt.'θaʊ.zʌnd.'tʉː.'hʌn.dɹʌ.dʌn.'twɛl.væn
fatherstuff	'fɑ.ðʌ.`stʌ
lusts	'lʌst
transfigured	tɹæn.'sfɪ.ɡʌ
copulation	`kɑ.pjʊə.'leɪ.ʃʌ
strippings	'stɹɪ.pɪŋ
convolutions	kɑn.vʌ.'lʉː.ʃʌn
tickling	'tɪ.klɪŋ
liveoak	'laɪ.vəʊ
lounger	'laʊn.dʒʌ
diaphanous	daɪ.'æ.fʌ.nʌ
hefts	'hɛft
gambols	'ɡæm.bɑl
exuding	ɛɡz.'jʉː.dɪŋ
scooting	'skʉː.tɪŋ
libidinous	lɪ.'bɪ.dɪ.nʌ
prophetical	pɹɑ.'fɛ.tɪ.kʌ
topmost	'tɑp.məʊs
bravuras	bɹæ.'vjʊə.ɹʌ
recitative	ɹɪ.'sɪ.tʌ.`tɪ
pedlars	'pɛd.lʌ
workpeople	'wəːk.pi.pʌ
heave'e'yo	'hi.vɪ.`ɛ.jəʊ
stevedores	'sti.vɪ.`dɔː
unlading	ʌn.'leɪ.dɪŋ
wharves	'wɔːv
whirr	'wəː
tinkles	'tɪŋ.kʌl
violincello	`vaɪ.ʌ.lɪn.'tʃɛ.ləʊ
orbic	'ɔː.bɪ
convulses	kʌn.'vʌl.sɪ
whirls	'wəːl
unnamable	ʌn.'neɪ.mʌ.bʌ
throbs	'θɹɑb
honeyed	'hʌ.nɪ
windpipe	'wɪnd.paɪ
quahaug	'kwæ.hɔː
provokers	pɹʌ.'vəʊ.kʌ
udder	'ʌ.dʌ
unbuttoning	ʌn.'bʌ.tʌ.nɪŋ
immodestly	ɪ.'mɑ.dʌst.li
headland	'hɛd.lʌn
unclench	ʌn.'klɛntʃ
sharptoothed	'ʃɑp.tʉːθ
compend	kʌm.'pɛn
compends	kʌm.'pɛnd
boundlessly	'baʊnd.lʌ.slɪ
omnific	ɑm.'nɪ.fɪ
journeywork	'dʒəː.nɪ.`wəː
pismire	'pɪ.smaɪ.ʌ
d'ouvre	'dʉː.vʌ
sextillions	sɛk.'stɪ.leɪ.ʌn
quadrupeds	'kwɑ.dɹʉːpt
mastadon	'mɑ.stæ.dʌ
creepers	'kɹi.pʌ
razorbilled	'ɹeɪ.zʌ.`bɪl
auk	'ɔː
kneels	'nil
omnigenous	ɑm.'nɪ.dʒʌ.nʌ
reachers	'ɹi.tʃʌ
remembrancers	ɹɪ.'mɛm.bɹɑn.sʌ
outgallop	aʊt.'ɡæ.lʌ
loafed	'ləʊf
paling	'peɪ.lɪŋ
quadrangular	kwɑ.'dɹæn.ɡjʊə.lʌ
lumbermen	'lʌm.bʌ.`mɛ
parsnips	'pɑ.snɪp
girdling	'ɡəːd.lɪŋ
cottonplant	'kɑ.tʌn.`plæn
persimmon	'pəː.sɪ.mʌ
longleaved	'lɑŋ.ɡliv
scrag	'skɹæ
wheatlot	'wit.lɑ
goldbug	'ɡəʊld.bʌ
flails	'fleɪl
andirons	'æn.daɪ.ʌn
festoons	fɛ.'stʉːn
triphammers	'tɹɪ.pʌ.mʌ
composedly	kʌm.'pəʊ.zɪd.lɪ
slipnoose	'slɪp.nʉː
forsakes	fɔː.'seɪk
hindways	'hɪn.dweɪ
shark's	'ʃɑk
nics	'nɪk
sqush	'skwʌʃ
pealings	'pi.lɪŋ
huskings	'hʌ.skɪŋ
raisings	'ɹeɪ.zɪŋ
gurgles	'ɡəː.ɡʌl
cackles	'kæ.kʌl
longlived	'lɑŋ.ɡlɪv
slappy	'slæ.pi
beehives	'bi.haɪv
icicled	'aɪ.sɪ.kʌl
chromatic	kɹəʊ.'mæ.tɪ
citrons	'sɪ.tɹɑn
quakeress	'kwæ.kʌ.ɹʌ
melodiously	mɛ.'ləʊ.dɪ.ʌ.sli
forenoon	fɔː.'nʉː
coffined	'kɑ.faɪn
voyaging	'vɔɪ.ɪ.dʒɪŋ
spheric	'sfɛ.ɹɪ
quintillions	kwɪn.'tɪ.leɪ.ʌn
chasms	'kæ.zʌm
foretruck	'fɔː.tɹʌ
watchfires	'wɑtʃ.faɪ.ʌ
gowned	'ɡaʊn
unshaved	ʌn.'ʃeɪv
twinges	'twɪn.dʒɪ
breastbone	'bɹɛst.bəʊ
artillerist	ɑ.'tɪ.lʌ.`ɹɪs
fort's	'fɔːt
reveille	ɹɪ.'veɪ
ambulanza	`æm.bjʊə.'læn.zʌ
whizz	'wɪ
entrenchments	ɛn.'tɹɛntʃ.mʌnt
jetblack	'dʒɛt.blæ
breastworks	'bɹɛs.twəːk
sunburnt	'sʌn.bəːn
muskets	'mʌ.skɪt
seabooks	'si.bʊək
mainmast	'meɪn.mɑs
musketry	'mʌ.skɪ.tɹi
maintop	'meɪn.tɑ
dabs	'dæb
spars	'spɑ
seabreeze	'si.bɹi
sedgy	'sɛ.dʒi
swash	'swɑʃ
irretrievable	ɪ.ɹɪ.'tɹi.vʌ.bʌ
spirting	'spəː.tɪŋ
wallabout	'wɑ.læ.`baʊ
unintermitted	`ʌ.`nɪn.tʌ.'mɪ.tɪ
carbines	'kɑ.baɪn
sinews	'sɪn.jʉː
shamefaced	'ʃeɪm.feɪs
extatic	ɛk.'stæ.tɪ
mockers	'mɑ.kʌ
bludgeons	'blʌ.dʒʌn
overstaid	`əʊ.vʌ.'steɪ
eleves	ɪ.'lɛv
southwesterner	saʊ.'θwɛ.stʌ.nʌ
uncombed	ʌn.'kəʊm
slowstepping	'sləʊ.stɛ.pɪŋ
pinings	'paɪ.nɪŋ
scarfed	'skɑf
infold	ɪn.'fəʊl
cottonfields	'kɑ.tʌn.`fild
privies	'pɹɪ.vi
nimbler	'nɪm.blʌ
bedclothes	'bɛd.kləʊð
despairer	dɪ.'spəː.ɹʌ
bafflers	'bæ.flʌ
spirt	'spəː
lithographing	'lɪ.θʌ.`ɡɹæ.fɪŋ
brahma	'bɹɑ.mʌ
adonai	'æ.dʌ.`naɪ
manito	mæ.'ni.təʊ
mexitli	mɛk.'sɪt.li
unfledged	ʌn.'flɛdʒ
deific	'deɪ.fɪ
laths	'lɑθ
mechanic's	mɪ.'kæ.nɪk
scythes	'saɪð
strewing	'stɹʉː.ɪŋ
orotund	'ɔː.ɹʌ.`tʌn
loosefingered	'lʉː.sɪ.`fɪŋ.ɡʌ
thrum	'θɹʌ
unsunk	ʌn.'sʌŋ
thorned	'θɔːn
thumb&#8212;that	'θʌ.'mænd.hæ.'ʃeɪt.'θaʊ.zʌnd.'tʉː.'hʌn.dɹʌ.dʌn.'twɛlv.'ðæ
thirsts	'θəːst
vexer's	'vɛk.sʌ
tressels	'tɹɛ.sʌl
spooning	'spʉː.nɪŋ
ploughing	'plaʊ.ɪŋ
ceiving	'si.vɪŋ
steamships	'stim.ʃɪp
concealments	kʌn.'sil.mʌnt
omniverous	ɑm.'nɪ.vʌ.ɹʌ
powowing	'paʊ.aʊ.ɪŋ
obis	'ɑ.bɪ
gymnosophist	dʒɪm.'nɑ.sʌ.`fɪs
vedas	'vɛ.dʌ
admirant	'æd.məː.ɹʌn
teokallis	tɪ.'ɑ.kæ.`li
knife&#8212;beating	'naɪ.'fænd.hæ.'ʃeɪt.'θaʊ.zʌnd.'tʉː.'hʌn.dɹʌ.dʌn.'twɛlv.'bi.tɪŋ
kneeling&#8212;to	'ni.lɪŋ.'ænd.hæ.'ʃeɪt.'θaʊ.zʌnd.'tʉː.'hʌn.dɹʌ.dʌn.'twɛlv.tʉː
puritan's	'pjʊə.ɹɪ.tʌn
rising&#8212	'ɹaɪ.zɪŋ.'ænd.hæ.'ʃeɪt.'θaʊ.zʌnd.'tʉː.'hʌn.dɹʌ.dʌn.'twɛl
frothing	'fɹɑ.θɪŋ
crisis&#8212;waiting	'kɹaɪ.sɪ.'sænd.hæ.'ʃeɪt.'θaʊ.zʌnd.'tʉː.'hʌn.dɹʌ.dʌn.'twɛlv.'weɪ.tɪŋ
centripetal	'sɛn.tɹaɪp.tʌ
atheistical	`eɪ.θɪ.'ɪ.stɪ.kʌ
mopers	'məʊ.pʌ
peeped	'pip
tubercled	'tjʉː.bʌ.kʌl
koboo	'kɑ.bʉː
ordure	'ɔːd.jʊə
encloser	ɛn.'kləʊ.zʌ
apices	'æ.pɪ.sɪ
traveled&#8212;and	'tɹæ.vʌl.'dænd.hæ.'ʃeɪt.'θaʊ.zʌnd.'tʉː.'hʌn.dɹʌ.dʌn.'twɛl.væn
foetid	'fi.tɪ
cohered	'kəʊ.hʌ
sauroids	'sɔː.ɹɔɪd
ahoy	æ.'hɔɪ
flowerbeds	'flaʊ.ʌ.`bɛd
balsamic	bɔːl.'sæ.mɪ
noiselessly	'nɔɪz.lʌ.slɪ
promulges	'pɹɑ.mʌl.dʒɪ
quadrillions	kwɑ.'dɹɪ.leɪ.ʌn
octillions	ɑk.'tɪ.leɪ.ʌn
space&#8212;and	'speɪ.'sænd.hæ.'ʃeɪt.'θaʊ.zʌnd.'tʉː.'hʌn.dɹʌ.dʌn.'twɛl.væn
chuff	'tʃʌ
enfolders	ɛn.'fəʊl.dʌ
wayfarer	'weɪ.fəː.ɹʌ
latherers	'lɑ.ðʌ.ɹʌ
pocketless	'pɑ.kɪt.lʌ
punctually	'pʌŋk.tʃʉː.ʌ.li
accoucheur	æ.kaʊ.'tʃəː
sweetscented	'swit.sʌn.tɪ
turbid	'təː.bɪ
steeps	'stip
soughing	'səʊ.ɪŋ
sunbeams	'sʌn.bim
debouch	'dɛ.baʊtʃ
untranslatable	ʌn.tɹæn.'sleɪ.tʌ.bʌ
yawp	'jɔː
effuse	ɪ.'fjʉː
workwoman	'wəː.kwʊə.mʌ
nighest	'naɪ.ʌs
pimpled&#8212;or	'pɪm.pʌl.'dænd.hæ.'ʃeɪt.'θaʊ.zʌnd.'tʉː.'hʌn.dɹʌ.dʌn.'twɛl.vɔː
prostitute&#8212;or	'pɹɑ.stɪt.`jʉː.'tænd.hæ.'ʃeɪt.'θaʊ.zʌnd.'tʉː.'hʌn.dɹʌ.dʌn.'twɛl.vɔː
now&#8212;or	'naʊ.'ænd.hæ.'ʃeɪt.'θaʊ.zʌnd.'tʉː.'hʌn.dɹʌ.dʌn.'twɛl.vɔː
impotence&#8212;or	'ɪm.pʌ.tʌn.'sænd.hæ.'ʃeɪt.'θaʊ.zʌnd.'tʉː.'hʌn.dɹʌ.dʌn.'twɛl.vɔː
untouching	ʌn.'tʌ.tʃɪŋ
whitefaced	'waɪt.feɪs
utahan	'jʉː.tæ.`hæ
arkansian	ɑ.'kæn.seɪ.ʌ
flatfoot	'flæt.fʊə
warflesh&#8212;fishtearer	'wɔː.flɛ.'ʃænd.hæ.'ʃeɪt.'θaʊ.zʌnd.'tʉː.'hʌn.dɹʌ.dʌn.'twɛlv.'fɪʃ.təː.ɹʌ
esquimaux	'ɛ.skwɪ.`mɔːk
snowhouse	'snəʊ.haʊ
bedowee&#8212;or	bɪ.'dəʊ.i.'ænd.hæ.'ʃeɪt.'θaʊ.zʌnd.'tʉː.'hʌn.dɹʌ.dʌn.'twɛl.vɔː
nomad&#8212;or	'nəʊ.mæ.'dænd.hæ.'ʃeɪt.'θaʊ.zʌnd.'tʉː.'hʌn.dɹʌ.dʌn.'twɛl.vɔː
tabounschik	'tæ.baʊns.`tʃɪ
babe&#8212;of	'beɪ.'bænd.hæ.'ʃeɪt.'θaʊ.zʌnd.'tʉː.'hʌn.dɹʌ.dʌn.'twɛl.vɑ
wife&#8212;and	'waɪ.'fænd.hæ.'ʃeɪt.'θaʊ.zʌnd.'tʉː.'hʌn.dɹʌ.dʌn.'twɛl.væn
daughter&#8212;and	'dɔː.tʌ.'ænd.hæ.'ʃeɪt.'θaʊ.zʌnd.'tʉː.'hʌn.dɹʌ.dʌn.'twɛl.væn
mother&#8212;and	'mʌ.ðʌ.'ænd.hæ.'ʃeɪt.'θaʊ.zʌnd.'tʉː.'hʌn.dɹʌ.dʌn.'twɛl.væn
rich&#8212;boys	'ɹɪ.'tʃænd.hæ.'ʃeɪt.'θaʊ.zʌnd.'tʉː.'hʌn.dɹʌ.dʌn.'twɛlv.'bɔɪ
mano'warsmen	'mæ.nʌ.`wɔːz.mɛ
nigher	'naɪ.ʌ
value&#8212;but	'væl.jʉː.'ænd.hæ.'ʃeɪt.'θaʊ.zʌnd.'tʉː.'hʌn.dɹʌ.dʌn.'twɛlv.`bʌ
appleshaped	'æ.pʌl.`ʃeɪp
mot	'mɑ
reconnoissance	`ɹi.'kɑ.nʌ.sʌn
shade&#8212;the	'ʃeɪ.'dænd.hæ.'ʃeɪt.'θaʊ.zʌnd.'tʉː.'hʌn.dɹʌ.dʌn.'twɛlv.ðʌ
identity&#8212;the	aɪ.'dɛn.tɪ.ti.'ænd.hæ.'ʃeɪt.'θaʊ.zʌnd.'tʉː.'hʌn.dɹʌ.dʌn.'twɛlv.ðʌ
complaisance	kʌm.'pleɪ.sʌn
things&#8212;the	'θɪŋ.'zænd.hæ.'ʃeɪt.'θaʊ.zʌnd.'tʉː.'hʌn.dɹʌ.dʌn.'twɛlv.ðʌ
man&#8212	'mæ.'nænd.hæ.'ʃeɪt.'θaʊ.zʌnd.'tʉː.'hʌn.dɹʌ.dʌn.'twɛl
farmwork	'fɑm.wəː
collections&#8212;and	kʌ.'lɛk.ʃʌn.'zænd.hæ.'ʃeɪt.'θaʊ.zʌnd.'tʉː.'hʌn.dɹʌ.dʌn.'twɛl.væn
good&#8212;for	'ɡʊə.'dænd.hæ.'ʃeɪt.'θaʊ.zʌnd.'tʉː.'hʌn.dɹʌ.dʌn.'twɛlv.fɔː
exurge	ɛɡ.'zəːdʒ
hour&#8212;and	'aʊ.ʌ.'ænd.hæ.'ʃeɪt.'θaʊ.zʌnd.'tʉː.'hʌn.dɹʌ.dʌn.'twɛl.væn
cornices	'kɔː.nɪ.sɪ
drums&#8212	'dɹʌm.'zænd.hæ.'ʃeɪt.'θaʊ.zʌnd.'tʉː.'hʌn.dɹʌ.dʌn.'twɛl
romanza	ɹəʊ.'mæn.zʌ
lookingglass	'lʊə.kɪŋ.`ɡlɑ
things&#8212	'θɪŋ.'zænd.hæ.'ʃeɪt.'θaʊ.zʌnd.'tʉː.'hʌn.dɹʌ.dʌn.'twɛl
betweendays	bɪ.'twin.deɪ
anklechain	'æŋ.klɪ.`tʃeɪ
bedhouse	'bɛd.haʊ
school&#8212;spelling	'skʉː.'lænd.hæ.'ʃeɪt.'θaʊ.zʌnd.'tʉː.'hʌn.dɹʌ.dʌn.'twɛlv.'spɛ.lɪŋ
ciphering	'saɪ.fʌ.ɹɪŋ
pasturelife	'pɑs.tʃʌ.`ɹɛ.laɪ
foddering	'fɑ.dʌ.ɹɪŋ
manures	mʌn.'jʊə
currycomb	'kʌ.ɹɪ.`kəʊ
mangers	'meɪn.dʒʌ
jointer	'dʒɔɪn.tʌ
smoothingplane	'smʉː.ðɪŋ.`pleɪ
plumbob	'plʌm.bɑ
tarpaulin	'tɑ.pʌ.`lɪ
lanyards	'læn.jɑd
sloop's	'slʉːp
pennanted	'pɛ.nʌn.tɪ
sinkers	'sɪŋ.kʌ
smallarms	'smɔː.lɑm
wadding	'wɑ.dɪŋ
housechairs	'haʊs.tʃəː
counterpane	'kaʊn.tʌ.`peɪ
theindefi	'θeɪn.dɪ.`fi
trowsers	'tɹəʊ.zʌ
bunkroom	'bʌŋ.kɹʉː
wristlet	'ɹɪ.slʌ
stonebreakers	'stəʊn.bɹeɪ.kʌ
coppersmiths	'kɑ.pʌ.`smɪθ
etui	'ɛt.jʉː.`i
oculist's	'ɑ.kjʊə.`lɪst
aurist's	'ɔː.ɹɪst
tinroofing	'tɪn.ɹʉː.fɪŋ
shingledressing	'ʃɪŋ.ɡʌl.`dɹɛ.sɪŋ
shipcarpentering	'ʃɪp.kɑ.pʌn.tʌ.ɹɪŋ
flaggers	'flæ.ɡʌ
dockbuilding	'dɑk.bɪl.dɪŋ
fishcuring	'fɪʃ.kjʊə.ɹɪŋ
piledriver	'paɪl.dɹaɪ.vʌ
coalkiln	'kəʊl.kɪl
brickkiln	'bɹɪk.kɪl
ironworks	'aɪ.ʌn.wəːk
whiteleadworks	'waɪt.li.`dwəːk
sugarhouse	'ʃʊə.ɡʌ.`haʊ
cottonbale	'kɑ.tʌn.`beɪ
stevedore's	'sti.vɪ.`dɔː
coalscreener	'kəʊl.skɹi.nʌ
workingknife	'wəː.kɪŋ.`naɪ
handpress	'hænd.pɹɛ
frisket	'fɹɪ.skɪ
tympan	'tɪm.pæ
compositor's	'kɑm.pʌ.`sɪ.tʌ
daguerreotyping	'deɪ.ɡɹɪ.`ɑ.taɪ.pɪŋ
rigger	'ɹɪ.ɡʌ
grappler	'ɡɹæ.plʌ
blockmaker	'blɑk.meɪ.kʌ
guttapercha	'ɡʌ.tæ.pʌ.tʃʌ
papiermache	'pæ.peɪ.ʌ.ʌ.`mæʃ
glaziers	'ɡleɪ.zeɪ.ʌ.ʌ
plements	'plɛ.mʌnt
gluepot	'ɡlʉː.pɑ
confectioner's	kʌn.'fɛk.ʃʌ.nʌ
decanter	dɪ.'kɑn.tʌ
flatiron	'flæ.taɪ.ʌ
awl	'ɔː
kneestrap	'ni.stɹæ
writingpen	'ɹɪ.tɪŋ.pʌ
tenpins	'tɛn.pɪn
oilcloths	'ɔɪl.klɑθ
bookbinder's	'bʊək.baɪn.dʌ
leatherdressing	'lɛ.ðʌ.`dɹɛ.sɪŋ
coachmaking	'kəʊtʃ.meɪ.kɪŋ
boilermaking	'bɔɪ.lʌ.`meɪ.kɪŋ
ropetwisting	'ɹəʊp.twɪ.stɪŋ
signpainting	'saɪn.peɪn.tɪŋ
limeburning	'laɪm.bəː.nɪŋ
coopering	'kʉː.pʌ.ɹɪŋ
cottonpicking	'kɑ.tʌn.`pɪ.kɪŋ
walkingbeam	'wɔː.kɪŋ.`bi
stavemachines	'steɪv.mʌ.`ʃin
plainingmachines	'pleɪ.nɪŋ.mʌ.`ʃin
snowplough	'snəʊ.plaʊ
bearhunt	'bəː.hʌn
coonhunt	'kʉːn.hʌn
shopwindows	'ʃɑp.wɪn.`dəʊ
sexton's	'sɛk.stʌn
wareroom	'wəː.ɹʉː
fruitstand	'fɹʉːt.stæn
milliner's	'mɪ.lɪ.nʌ
dressmaker's	'dɹɛ.smeɪ.kʌ
sweetmeats	'swit.mit
cookpans	'kʊək.pæn
deposite	dɪ.'pɑ.sɪ
estima	'ɛ.stɪ.mʌ
tion	tɪ.'ɑ
leadings	'li.dɪŋ
lovingest	'lʌ.vɪŋ.ɡʌs
plast	'plɑs
silversmiths	'sɪl.vʌ.`smɪθ
nightwatchman's	'naɪ.twɑtʃ.mʌn
warrantee	'wɑ.ɹɑn.`ti
retrospection	`ɹɛ.tɹəʊ.'spɛk.ʃʌ
beginningless	bɪ.'ɡɪ.nɪŋ.lʌ
accouchement	æ.'kʉːʃ.mɔː
soreness	'sɔː.nʌ
camphor	'kæm.fʌ
slowmoving	'sləʊ.mʉː.vɪŋ
ferrywharf	'fɛ.ɹɪ.`wɔː
stagedriver	'steɪ.dʒɪ.`dɹaɪ.vʌ
cortege	'kɔː.tɛdʒ
deathbell	'dɛθ.bɛ
uncloses	ʌn.'kləʊ.zɪ
shovelled	'ʃʌ.vʌl
freemouthed	'fɹi.maʊð
quicktempered	'kwɪk.tɛm.pʌ
badlooking	'bæd.lʊə.kɪŋ
lowspirited	'ləʊ.spɪ.`ɹɪ.tɪ
wetweather	'wɛ.twɛ.ðʌ
loafing	'ləʊ.fɪŋ
workingman's	'wəː.kɪŋ.mʌn
workingmen	'wəː.kɪŋ.`mɛ
nomina	'nɑ.mɪ.nʌ
ternal	'təː.nʌ
well&#8212;for	'wɛ.'lænd.hæ.'ʃeɪt.'θaʊ.zʌnd.'tʉː.'hʌn.dɹʌ.dʌn.'twɛlv.fɔː
houses&#8212;they	'haʊ.zɪ.'zænd.hæ.'ʃeɪt.'θaʊ.zʌnd.'tʉː.'hʌn.dɹʌ.dʌn.'twɛlv.ðeɪ
father&#8212;it	'fɑ.ðʌ.'ænd.hæ.'ʃeɪt.'θaʊ.zʌnd.'tʉː.'hʌn.dɹʌ.dʌn.'twɛl.vɪ
weft	'wɛf
foreheadless	'fɔː.hɛd.lʌ
crowfoot	'kɹəʊ.fʊə
camanche	'kæ.mɑntʃ
mocker	'mɑ.kʌ
time&#8212;that	'taɪ.'mænd.hæ.'ʃeɪt.'θaʊ.zʌnd.'tʉː.'hʌn.dɹʌ.dʌn.'twɛlv.'ðæ
satis	'sæ.ti
minutest	maɪn.'jʉː.tʌs
cohering	'kəʊ.hʌ.ɹɪŋ
ennuyees	ɛ.'naɪ.i
onanists	'ɑ.næ.`nɪst
doored	'dɔː
enfolds	ɛn.'fəʊld
worstsuffering	'wəːst.sʌ.fʌ.ɹɪŋ
everlaughing	`ɛ.vʌ.'lɑ.fɪŋ
douceurs	daʊ.'səː
journeymen	'dʒəː.nɪ.`mɛ
blackguards	'blæk.ɡɑd
mirthshouting	'məːθ.ʃaʊ.tɪŋ
stammerer	'stæ.mʌ.ɹʌ
wellformed	'wɛl.fɔːm
expectantly	ɛk.'spɛk.tʌnt.li
hotcheeked	'hɑ.tʃik
pity's	'pɪ.ti
strawbottom	'stɹɔː.bɑ.tʌ
starshine	'stɑ.ʃaɪ
see&#8212;and	'si.'ænd.hæ.'ʃeɪt.'θaʊ.zʌnd.'tʉː.'hʌn.dɹʌ.dʌn.'twɛl.væn
headforemost	'hɛd.fɔː.`məʊs
ruffianly	'ɹʌ.feɪ.ʌn.li
pastreading	'pɑ.stɹɛ.dɪŋ
razory	'ɹeɪ.zʌ.ɹi
blanched	'blɑntʃ
wellbeloved	'wɛl.bɪ.`lʌv
encircles	ɛn.'səː.kʌl
breakfasttime	'bɹeɪk.fɑst.`taɪ
rushbottoming	'ɹʌʃ.bʌ.tʌ.mɪŋ
halfenveloped	`hɑ.fʌn.'vɛ.lʌp
tallborne	'tɔːl.bɔː
defile	dɪ.'faɪ
amour	'æ.mʌ
gallivant	'ɡæ.lɪ.`væn
wellfilled	'wɛl.fɪl
wellknown	'wɛl.nəʊ
welloff	'wɛ.lɑ
scotchman	'skɑtʃ.mʌ
welchman	'wɛltʃ.mʌ
foots	'fʊət
ennuyee	ɛ.'naɪ.i
onanist	'ɑ.næ.`nɪs
unre	ʌn.'ɹi
quited	'kwaɪ.tɪ
perfectformed	pʌ.'fɛkt.fɔːm
weeper	'wi.pʌ
consumptive	kʌn.'sʌmp.tɪ
erysipalite	'əː.ɹɪ.`sɪ.pʌ.`laɪ
antipodes	`æn.tɪ.'pəʊd
embowered	ɛm.'baʊ.ʌ
encloses	ɛn.'kləʊ.zɪ
wellgrown	'wɛl.ɡɹəʊ
unclothed	ʌn.'kləʊð
ungrown	ʌn.'ɡɹəʊ
measureless	'mɛ.ʒʌ.lʌ
inarmed	ɪ.'nɑm
sweatings	'swɛ.tɪŋ
stiflings	'staɪ.flɪŋ
paralysed	'pæ.ɹʌ.`laɪz
convulsed	kʌn.'vʌlz
invigoration	ɪn.`vɪ.ɡʌ.'ɹeɪ.ʃʌ
engirth	ɛn.'ɡəːθ
defiled	dɪ.'faɪl
wellmade	'wɛl.meɪ
shoulderside	'ʃəʊl.dʌ.`saɪ
swimmingbath	'swɪ.mɪŋ.`bɑθ
greenshine	'ɡɹin.ʃaɪ
mortising	'mɔː.taɪ.zɪŋ
rowers	'ɹəʊ.ʌ
rowboats	'ɹəʊ.bəʊt
dinnerkettles	'dɪ.nʌ.`kɪ.tʌl
cowyard	'kaʊ.jɑ
sleighdriver	'sleɪ.dɹaɪ.vʌ
goodnatured	'ɡʊəd.nʌ.tʃʌ
nativeborn	'neɪ.tɪ.`vɛ.bɔː
upperhold	'ʌ.pʌ.`həʊl
underhold&#8212;the	`ʌn.dʌ.'həʊl.'dænd.hæ.'ʃeɪt.'θaʊ.zʌnd.'tʉː.'hʌn.dɹʌ.dʌn.'twɛlv.ðʌ
costumes&#8212;the	'kɑst.jʉːm.'zænd.hæ.'ʃeɪt.'θaʊ.zʌnd.'tʉː.'hʌn.dɹʌ.dʌn.'twɛlv.ðʌ
cleansetting	'klin.sɪ.tɪŋ
waistbands	'weɪst.bænd
again&#8212	æ.'ɡɛ.'nænd.hæ.'ʃeɪt.'θaʊ.zʌnd.'tʉː.'hʌn.dɹʌ.dʌn.'twɛl
suchlike	'sʌtʃ.laɪ
tanfaced	'tæn.feɪs
shipjoiner	'ʃɪp.dʒɔɪ.nʌ
fowling	'faʊ.lɪŋ
exhales	ɛks.'heɪl
ungovern	ʌn.'ɡʌ.vʌ
8212;all	'eɪt.'θaʊ.zʌnd.'tʉː.'hʌn.dɹʌ.dʌn.'twɛl.'vɔː
loveflesh	'lʌv.flɛʃ
sweetfleshed	'swit.flɛʃ
ceive	'si
inexpress	`ɪ.nɛk.'spɹɛ
ible	'aɪ.bʌ
roues	'ɹaʊ
fullspread	'fʊəl.spɹɛ
dullfaced	'dʌl.feɪs
dullface	'dʌl.feɪ
sloven	'slʌ.vʌ
allbaffling	ɔːl.'bæ.flɪŋ
stript	'stɹɪp
lifelit	'laɪ.flɪ
breastmuscle	'bɹɛst.mʌ.sʌ
goodsized	'ɡʊəd.saɪz
reachings	'ɹi.tʃɪŋ
embodiments	ɛm.'bɑ.dɪ.mʌnt
firmfibred	'fəːm.faɪ.bɹʌ
defiles	dɪ.'faɪl
sauntering	'sɔːn.tʌ.ɹɪŋ
byroad	'baɪ.ɹəʊ
suavity	sjʉː.'æ.vɪ.ti
ideality	aɪ.'deɪ.ʌ.lɪ.ti
backtop	'bæk.tɑ
veneration	`vɛ.nʌ.'ɹeɪ.ʃʌ
thongs	'θɑŋ
milknosed	'mɪlk.nəʊz
wrig	'ɹɪ
sibilant	'sɪ.bɪ.lʌn
drugshelf	'dɹʌɡ.ʃɛl
caoutchouc	'keɪ.ʌ.`ɹʌ.tʃaʊ
hog's	'hɑɡ
halfpulled	'hɑf.pʊəl
dismalest	dɪ.'smeɪ.lʌs
creased	'kɹis
cadaverous	kæ.'dæ.vʌ.ɹʌ
neath	'niθ
splay	'spleɪ
fores	'fɔː
unmuzzled	ʌn.'mʌ.zʌl
pioneercaps	pɪ.'əʊ.nʌ.`kæp
fullgrown	'fʊəl.ɡɹəʊ
blushingly	'blʌ.ʃɪŋ.lɪ
albescent	æl.'bɛ.sʌn
whist	'wɪs
wildcherry	'waɪld.tʃʌ.ɹi
catbrier	'kæt.bɹɪ.ʌ
creamhued	'kɹim.hjʉː
distaff	dɪ.'stɑ
immerses	ɪ.'məː.sɪ
haughtiest	'hɔː.tɪ.ʌs
domiciles	'dɑ.mɪ.`saɪl
plasticity	plɑ.'stɪ.sɪ.ti
associ	æ.'səʊ.saɪ
ations	'eɪ.ʃʌn
answerer	'ɑn.sʌ.ɹʌ
passkey	'pɑ.skɪ
indifferently	ɪn.'dɪ.fɹʌnt.li
cudge	'kʌdʒ
deckhand	'dɛk.hæn
rence	'ɹɛn
insulter	'ɪn.sʌl.tʌ
transmutes	tɹæns.'mjʉːt
apprenticeboy	æ.'pɹɛn.taɪ.`sɛ.bɔɪ
le'pt	'lɛp
worming	'wəː.mɪŋ
sycophant	'sɪ.kɑ.fʌn
gibbet	'dʒɪ.bɪ
gibbets	'dʒɪ.bɪt
unslaughter'd	ʌn.'slɔː.tʌ
dragoons	dɹæ.'ɡʉːn
fifes	'faɪf
cutlasses	'kʌt.lʌ.sɪ
uncountable	ʌn.'kaʊn.tʌ.bʌ
mothy	'mɑ.θi
ague	'eɪ.ɡjʉː
convulse	kʌn.'vʌl
firelocks	'faɪ.ʌ.lɑk
limpers	'lɪm.pʌ
graveclothes	'ɡɹeɪv.kləʊð
blackbellied	'blæk.bɛ.lɪ
roarers	'ɹɔː.ɹʌ
centrepiece	'sɛn.tʌ.`pi
morningglories	'mɔː.nɪŋ.ɡlʌ.`ɹi
sow's	'səʊ
appletrees	'æ.pʌl.`tɹi
schoolmistress	'skʉːl.mɪ.stɹʌ
freshcheeked	'fɹɛʃ.tʃik
birthed	'bəːθ
suppertable	'sʌ.pʌ.tʌ.bʌ
selfsufficient	'sɛlf.sʌ.`fɪ.ʃʌn
gainsayed	'ɡeɪn.seɪ
aureola	`ɔː.ɹɪ.'əʊ.lʌ
slacktowed	'slæk.təʊ
astern	æ.'stəː
quickbroken	'kwɪk.bɹəʊ.kʌ
maroontint	mæ.'ɹʉːn.tɪn
seacrow	'si.kɹəʊ
shoremud	'ʃɔː.mʌ
peruses	pʌ.'ɹʉː.zɪ
salaams	'sæ.lɑm
1819	'wɑn.'θaʊ.zʌn.'deɪt.'hʌn.dɹʌ.dʌn.'naɪn.ti
1855	'wɑn.'θaʊ.zʌn.'deɪt.'hʌn.dɹʌ.dʌn.'fɪf.ti.'faɪ
anyhow&#8212;are	'ɛ.nɪ.`haʊ.'ænd.hæ.'ʃeɪt.'θaʊ.zʌnd.'tʉː.'hʌn.dɹʌ.dʌn.'twɛl.vɑ
helmsmen	'hɛlmz.mɛ
fullblown	'fʊəl.bləʊ
wealth&#8212;which	'wɛl.'θænd.hæ.'ʃeɪt.'θaʊ.zʌnd.'tʉː.'hʌn.dɹʌ.dʌn.'twɛlv.'wɪtʃ
enfolding	ɛn.'fəʊl.dɪŋ
freetrade	'fɹi.tɹeɪ
telegraphs	'tɛ.lɪ.`ɡɹæf
passionless	'pæ.ʃʌn.lʌ
sojourner	'səʊ.dʒəː.nʌ
trances	'tɹɑn.sɪ
mountings	'maʊn.tɪŋ
burthen	'bəː.ðʌ
trackless	'tɹæ.klʌ
consecrates	'kɑn.sɪ.`kɹeɪt
matins	'mæ.tɪn
vespers	'vɛ.spʌ
rustled	'ɹʌ.sʌl
ruralised	'ɹʊə.ɹʌ.`laɪz
æolian	eɪ.'ɑ.leɪ.ʌ
straggling	'stɹæ.ɡlɪŋ
labourer	'leɪ.bəː.ɹʌ
things—the	'θɪŋz.ðʌ
therewith	ðəː.'wɪð
phantasies	'fɑn.tʌ.si
temperately	'tɛm.pʌ.ɹʌt.li
ripens	'ɹaɪ.pʌn
goadings	'ɡəʊ.dɪŋ
swellings	'swɛ.lɪŋ
swains	'sweɪn
reposing	ɹɪ.'pəʊ.zɪŋ
enchantments	ɛn.'tʃɑnt.mʌnt
blazonry	'bleɪ.zɑn.ɹi
votive	'vəʊ.tɪ
meekness	'mik.nʌ
hallowing	'hæ.ləʊ.ɪŋ
sertorius	səː.'tɔː.ɹɪ.ʌ
tyrannic	tɪ.'ɹæ.nɪ
souled	'səʊl
frenchman,(1	'fɹɛntʃ.mʌn.'wɑ
gustavus	'ɡʌ.stæ.vʌ
dalecarlia's	deɪl.'kɑ.leɪ.ʌ
variegated	'vəː.ɹɪ.`ɡeɪ.tɪ
unsubstantial	ʌn.sʌb.'stæn.ʃʌ
mellower	'mɛ.ləʊ.ʌ
voluptuously	vʌ.'lʌp.tʃʉː.ʌ.sli
recreant	'ɹɛ.kɹi.ʌn
listlessness	'lɪst.lʌ.snʌ
unprofitably	ʌn.'pɹɑ.fɪ.tʌ.blɪ
shallows	'ʃæ.ləʊ
derwent	'dəː.wʌn
holms	'həʊm
ragwort	'ɹæ.ɡwɔː
skiddaw's	'skɪ.dɔː
transplanted—there	tɹæn.'splæn.tɪd.'ðəː
springes	'spɹɪn.dʒɪ
woodcocks	'wʊəd.kɑk
scudding	'skʌ.dɪŋ
visitation;—moon	`vɪ.zɪ.'teɪ.ʃʌn.'mʉː
breathings	'bɹi.ðɪŋ
undistinguishable	ʌn.dɪ.'stɪŋ.ɡwɪ.ʃʌ.bʌ
plunderers	'plʌn.dʌ.ɹʌ
raven's	'ɹeɪ.vʌn
crag	'kɹæ
earth—and	'əː.θæn
vexations	vɛk.'seɪ.ʃʌn
lassitudes	'læ.sɪt.`jʉːd
visitings	'vɪ.zɪ.tɪŋ
hurtless	'həːt.lʌ
severer	'sɛ.vʌ.ɹʌ
unloosed	ʌn.'lʉːs
lustily	'lʌ.stɪ.lɪ
sanctifying	'sɑnk.tɪ.`faɪ.ɪŋ
recognise	'ɹɛ.kʌɡ.`naɪ
stinted	'stɪn.tɪ
us—for	'ʌ.sfɔː
six,—i	'sɪk.'saɪ
untired	ʌn.'taɪ.ʌ
pleasures,—the	'plɛ.ʒʌz.'ðʌ
chiming	'tʃaɪ.mɪŋ
precipices	'pɹɛ.sɪ.`pɪ.sɪ
sportively	'spɔː.tɪv.li
sideway	'saɪ.dweɪ
me—even	`mi.'i.vʌ
feebler	'fi.blʌ
dreamless	'dɹim.lʌ
uselessly	'jʉː.slʌ.slɪ
windings	'waɪn.dɪŋ
unfading	ʌn.'feɪ.dɪŋ
exultations	ɛɡ.zʌl.'teɪ.ʃʌn
parcelled	'pɑ.sʌl
ungratefully	ʌn.'ɡɹeɪt.fʌ.lɪ
husbanded	'hʌs.bʌn.dɪ
diamonds,—clubs	'daɪ.ʌ.mʌndz.'klʌb
piteously	'pɪ.teɪ.ʌ.sli
splendour's	'splɛn.dʌ
esthwaite's	'ɛs.θweɪt
bothnic	'bəʊθ.nɪ
changeful	'tʃeɪndʒ.fʌ
cumbria's	'kʌm.bɹi.ʌ
shield;—the	'ʃild.'ðʌ
rememberable	ɹɪ.'mɛm.bʌ.ɹʌ.bʌ
maturer	mʌ.'tʃʊə.ɹʌ
impregnate	'ɪm.`pɹɛɡ.neɪ
early—not	'əː.lɪ.'nɑ
memory—ere	'mɛ.mʌ.`ɹi.'əː
snowdrops	'snəʊ.dɹɑp
reproaches	ɹɪ.'pɹəʊ.tʃɪ
honourable	'ɑ.nʌ.ɹʌ.bʌ
me;—'tis	'mi.'tɪ
discomfited	dɪ.'skɑm.fɪ.tɪ
time.—(continued	'taɪm.kʌn.'tɪn.jʉː
endeavoured	ɛn.'dɛ.vʌ
befal	bɪ.'fæ
lingerer	'lɪŋ.ɡʌ.ɹʌ
virtue's	'vəː.tʃʉː
be;—who	'bi.'hʉː
infantine	ɪn.'fɑn.ti
tranquillising	'tɹæn.kwɪ.`laɪ.zɪŋ
consciousnesses	'kɑn.ʃʌ.snʌ.sɪ
huckster's	'hʌk.stʌ
collaterally	kʌ.'læ.tʌ.ɹʌ.li
languidly	'læŋ.ɡwɪd.li
windermere	'wɪn.dʌ.`meɪ.ʌ.ʌ
chaunted	'tʃɔːn.tɪ
diffidence	'dɪ.fɪ.dʌn
sufficing	sʌ.'faɪ.sɪŋ
hunger—hence	'hʌŋ.ɡʌ.'hɛn
unsapped	ʌn.'sæp
quartered	'kwɔː.tʌ
weightier	'weɪ.tɪ.ʌ
largely;—proud	'lɑdʒ.li.'pɹaʊ
adventure's	æd.'vɛn.tʃʌ
mouldering	'məʊl.dʌ.ɹɪŋ
remounted	ɹɪ.'maʊn.tɪ
chauntry	'tʃɔːn.tɹi
that—though	'ðæt.`ðəʊ
sobbings	'sɑ.bɪŋ
respirations	`ɹɛ.spɪ.'ɹeɪ.ʃʌn
roofless	'ɹʉː.flʌ
drops—yet	'dɹɑps.'jɛ
homewards	'həʊm.wʌd
winander's	'wɪ.næn.dʌ
chaises	'ʃeɪ.zɪ
decanters	dɪ.'kɑn.tʌ
but—though	`bʌt.'ðəʊ
rock—oh	'ɹɑ.'kəʊ
appertained	æ.'pəː.teɪn
intervenient	`ɪn.tʌ.'vi.nɪ.ʌn
succedaneum	sʌk.`sɛ.dæ.'ni.ʌ
unblinded	ʌn.'blaɪn.dɪ
analyse	'æ.næ.`laɪ
irradiates	ɪ.'ɹeɪ.dɪ.`eɪt
beautified	'bjʉː.tɪ.`faɪ
beholds.—such	bɪ.'həʊldz.'sʌtʃ
verily	'vɛ.ɹɪ.lɪ
chamois	'tʃæm.wɑ
influxes	'ɪn.flʌk.sɪ
wheresoe'er	'wəː.səʊ.ʌ
inobtrusive	ɪ.nɑb.'tɹʉː.sɪ
agitations	`æ.dʒɪ.'teɪ.ʃʌn
unwatchful	ʌn.'wɑtʃ.fʌ
sublimer	'sʌ.blɪ.mʌ
unprofaned	ʌn.pɹʌ.'feɪn
exultation	ɛɡ.zʌl.'teɪ.ʃʌ
sublimity	sʌ.'blɪ.mɪ.ti
superadded	'sʉː.pʌ.`ɹæ.dɪ
early;—oft	'əː.lɪ.'ɑf
friend,(3	'fɹɛnd.'θɹi
marvellous	'mɑ.vʌ.lʌ
twere	'tweɪ.ʌ.ʌ
unsubdued	ʌn.sʌbd.'jʉː
communed	'kɑ.mjʉːn
obeisance	'əʊ.bɪ.sʌn
perchance	'pəː.tʃɑn
unorganic	ʌ.nɔː.'ɡæ.nɪ
seemeth	'si.mʌθ
liveth	'laɪvθ
gladsome	'ɡlæd.sʌ
communing	'kɑ.mjʉː.nɪŋ
fleshly	'flɛʃ.li
o'ercome	'ɔː.kʌ
unapprehensive	ʌ.`næ.pɹɪ.'hɛn.sɪ
o'erhung	'ɔː.hʌŋ
tasselled	'tæ.sʌl
o'ertasked	'ɔː.tɑsk
passed—nor	'pɑst.'nɔː
eddy's	'ɛ.di
roved	'ɹəʊv
fairy's	'fəː.ɹi
rimy	'ɹaɪ.mi
beard.—the	'beɪ.ʌ.ʌd.'ðʌ
suiting	'sʉː.tɪŋ
pealing	'pi.lɪŋ
neighbour	'neɪ.bʌ
favouring	'feɪ.vəː.ɹɪŋ
antechapel	`æn.tɪ.tʃæ.'pɛ
lecturer's	'lɛk.tʃʌ.ɹʌ
idlers	'aɪd.lʌ
recusants	ɹɪ.'kjʉː.sʌnt
dunces—of	'dʌn.sɪ.zɑ
tremblings	'tɹɛm.blɪŋ
recognised	'ɹɛ.kʌɡ.`naɪz
solaces	'sɑ.lɪ.sɪ
soever	`səʊ.'ɛ.vʌ
manhood's	'mæn.hʊəd
unembellished	ʌ.nɛm.'bɛ.lɪʃ
bears—the	'bəːz.ðʌ
incumbencies	ɪn.'kʌm.bʌn.si
upholder	ʌp.'həʊl.dʌ
respired	ɹɪ.'spaɪ.ʌ
me—'twas	'mi.'twɑ
madness—so	'mæd.nʌs.'səʊ
fruitfulness	'fɹʉːt.fʌl.nʌ
undisordered	ʌn.dɪ.'sɔː.dʌ
incommunicable	ɪn.kʌ.'mjʉː.nɪ.kʌ.bʌ
treasonable	'tɹi.zʌ.nʌ.bʌ
simplicity.—and	sɪm.'plɪ.sɪ.ti.'æn
beheld,—with	bɪ.'hɛl.'dwɪð
season—could	'si.zʌn.'kʊə
unpropped	ʌn.'pɹɑp
unburthened	ʌn.'bəː.ðʌn
unalarmed	ʌ.næ.'lɑm
companionships	kʌm.'pæ.neɪ.ʌn.`ʃɪp
sauntered	'sɔːn.tʌ
boisterously	'bɔɪ.stʌ.ɹʌ.sli
trompington	'tɹɑm.pɪŋ.tʌ
danger's	'deɪn.dʒʌ
awful—if	'ɔː.fʌ.lɪ
soul—i	'səʊ.'laɪ
familiarly	fʌ.'mɪ.leɪ.ʌ.ʌ.li
milton's	'mɪl.tʌn
confest	kʌn.'fɛs
libations	lɪ.'beɪ.ʃʌn
importunate	`ɪm.pɔː.'tʌ.neɪ
surplice	'səː.plɪ
clove	'kləʊ
burghers	'bəː.ɡʌ
remissly	ɹɪ.'mɪ.sli
likings	'laɪ.kɪŋ
pitch—duty	'pɪtʃd.'jʉː.ti
inaptly	ɪ.'næpt.li
discountenance	'dɪ.skaʊn.tʌ.nʌn
instil	ɪn.'stɪ
books,—that	'bʊəks.'ðæ
sense,—but	'sɛns.'bʌ
edifices	'ɛ.dɪ.fɪ.sɪ
congregating	'kɑŋ.ɡɹɪ.`ɡeɪ.tɪŋ
unripe	ʌn.'ɹaɪ
plainness	'pleɪn.nʌ
steeples	'sti.pʌl
schoolboy's	'skʉːl.bɔɪ
coverts	kəʊ.'vəːt
himself.—alas	hɪm.'sɛl.fæ.'læ
popinjays	'pɑ.pɪn.`dʒeɪ
abstemiousness	æb.'sti.meɪ.ʌ.snʌ
nurslings	'nəː.slɪŋ
pensioned	'pɛn.ʃʌn
folios	'fəʊ.lɪ.`əʊ
obolus	'ɑ.bɑ.lʌ
scholar!"—when	'skɑ.lʌ.'wɛ
bucer	'bjʉː.sʌ
melancthon	'mɛ.lɑnk.θʌ
gownèd	'ɡaʊn
pitiably	'pɪ.tɪ.ʌ.bli
shoal	'ʃəʊ
pillowy	'pɪ.ləʊ.i
interchanged	`ɪn.tʌ.'tʃeɪndʒ
unscoured	ʌn.'skaʊ.ʌ
portraitures	'pɔː.tɹɪ.tʃʌ
arras	æ.'ɹæ
humourists	'hjʉː.mʌ.`ɹɪst
loiterer	'lɔɪ.tʌ.ɹʌ
pourtrayed	'pɔː.tɹeɪ
artless	'ɑt.lʌ
rustic's	'ɹʌ.stɪk
flatteries	'flæ.tʌ.ɹi
idolator	'aɪ.dʌ.`leɪ.tʌ
unneighbourly	ʌn.'neɪ.bʌ.li
rampart's	'ɹæm.pɑt
valley(4	'væ.lɪ.'fɔː
thronèd	'θɹəʊn
liest	'lis
unsaluted	ʌn.sʌ.'lʉː.tɪ
quoth	'kwɑθ
nay—nay	'neɪ.'neɪ
schoolfellows	'skʉːl.fɪ.`ləʊ
recognitions	`ɹɛ.kʌɡ.'nɪ.ʃʌn
habiliments	'hæ.bɪ.`lɪ.mʌnt
thankfulness	'θæŋk.fʌl.nʌ
crags	'kɹæɡ
straightway	'stɹeɪ.tweɪ
regretted!—that	ɹɪ.'ɡɹɛ.tɪd.'ðæ
untuned	ʌnt.'jʉːn
transmuted	tɹæns.'mjʉː.tɪ
unacknowledged	ʌ.næk.'nɑ.lɪdʒ
undecaying	`ʌn.dɪ.'keɪ.ɪŋ
endeavours	ɛn.'dɛ.vʌ
coppice	'kɑ.pɪ
pantings	'pɑn.tɪŋ
prattlers	'pɹæt.lʌ
grandame	'ɡɹæn.deɪ
playmate's	'pleɪ.meɪt
disquietude	dɪ.'skwaɪ.ʌt.jʉː
heartedness	'hɑ.tɪd.nʌ
sirius	'sɪ.ɹɪ.ʌ
scatterings	'skæ.tʌ.ɹɪŋ
solacing	'sɑ.lɪ.sɪŋ
sights—weeds	'saɪt.'swid
doubtfully	'daʊt.fʌ.lɪ
off—i	'ɑ.'faɪ
gawds	'ɡɔːd
manliness	'mæn.li.nʌ
unworldly	ʌn.'wəːld.li
chastisement	'tʃɑ.staɪz.mʌn
gaiety	'ɡeɪ.ʌ.ti
unaimed	ʌ.'neɪm
tingled	'tɪŋ.ɡʌl
copse	'kɑp
beheld—in	bɪ.'hɛl.'dɪ
labourers	'leɪ.bəː.ɹʌ
inconsiderate	ɪn.kʌn.'sɪ.dʌ.ɹʌ
centre—hermit	'sɛn.tʌ.'həː.mɪ
pathless	'pɑθ.lʌ
that—after	ðæ.'tɑf.tʌ
none—but	'nʌn.`bʌ
meagre	'mi.ɡʌ
companionless	kʌm.'pæ.neɪ.ʌn.lʌ
steadiness—at	'stɛ.dɪ.nʌ.sæ
uncomplaining	ʌn.kʌm.'pleɪ.nɪŋ
oaken	'əʊ.kʌ
friendless	'fɹɛnd.lʌ
entreated	ɛn.'tɹi.tɪ
reproof	ɹɪ.'pɹʉː
endurest	ɛnd.'jʊə.ɹʌs
feel—we	'fil.wi
kindlings	'kɪnd.lɪŋ
morning—presage	'mɔː.nɪŋ.'pɹɛ.sɪdʒ
hauntings	'hɔːn.tɪŋ
cervantes	səː.'vɑn.teɪ
unerring	ʌ.'nəː.ɹɪŋ
euclid's	'jʉː.klɪd
treasure.—lance	'tɹɛ.ʒʌ.'lɑn
unwieldly	ʌn.'wild.li
solitudes	'sɑ.lɪt.`jʉːd
soberness	'səʊ.bʌ.nʌ
maniac's	'meɪ.nɪ.`æk
entrancement	'ɛn.tɹʌn.smʌn
unthanked	ʌn.'θæŋk
lisping	'lɪ.spɪŋ
prattling	'pɹæt.lɪŋ
ingrate's	ɪn.'ɡɹeɪt
beseemed	bɪ.'sim
breathe?—what	'bɹið.'wɑ
inspirèd	'ɪn.spaɪ.ʌ
england,—from	'ɪŋ.ɡlʌnd.'fɹɑ
warblings	'wɔː.blɪŋ
cottagers	'kɑ.tɪ.dʒʌ
unperilous	ʌn.'pɛ.ɹɪ.lʌ
noosed	'nʉːs
stallèd	'stɔːl
debarred	dɪ.'bɑ
prelibation	pɹɪ.lɪ.'beɪ.ʃʌ
mower's	'məʊ.ʌ
undischarged	ʌn.dɪs.'tʃɑdʒ
ransacks	'ɹæn.sæk
learnings	'ləː.nɪŋ
simplicities	sɪm.'plɪ.sɪ.ti
overweeningly	`əʊ.vʌ.'wi.nɪŋ.lɪ
she—not	ʃi.'nɑ
benignity	bɪ.'nɪɡ.nɪ.ti
seemliness	'sim.li.nʌ
dimpling	'dɪm.plɪŋ
tree.—poor	'tɹi.'pʊə
intermeddler	`ɪn.tʌ.'mɛd.lʌ
pinfold	'pɪn.fəʊl
fortunatus	'fɔː.tʌ.`næ.tʌ
overbridged	`əʊ.vʌ.'bɹɪdʒ
froward	'fɹaʊ.ʌ
futurity	'fjʉː.tʃʌ.ɹɪ.ti
unfruitful	ʌn.'fɹʉːt.fʌ
winander!—many	'wɪ.næn.dʌ.'mɛ.ni
hootings	'hʉː.tɪŋ
peals	'pil
halloos	'hæ.lʉː
feet,—forgetful	'fit.fʌ.'ɡɛt.fʌ
herded!—(easily	'həː.dɪ.'di.zɪ.lɪ
letters—but	'lɛ.tʌz.`bʌ
unresentful	`ʌn.ɹɪ.'sɛnt.fʌ
strengtheners	'stɹɛŋ.θʌ.nʌ
intrusted	ɪn.'tɹʌ.stɪ
peninsulas	pʌ.'nɪns.jʊə.lʌ
faëry	'fæ.ɛ.ɹi
respites	'ɹɛ.spaɪt
angler's	'æŋ.ɡlʌ
monkish	'mʌn.kɪʃ
extravagate	ɛk.'stɹæ.vʌ.`ɡeɪ
mettlesome	'mɛ.tʌl.`sʌ
drivellers	'dɹɪ.vɛ.lʌ
dotards	'dɑ.tɑd
possession,—ye	pʌ.'zɛ.ʃʌn.'ji
crouches	'kɹaʊ.tʃɪ
us,—nothing	'ʌ.'snʌ.θɪŋ
untutored	ʌnt.'jʉː.tʌ
extasy	ɛk.'stæ.si
changes,—there	'tʃeɪn.dʒɪz.'ðəː
turnings	'təː.nɪŋ
granta's	'ɡɹɑn.tʌ
undepressed	`ʌn.dɪ.'pɹɛs
repining	ɹɪ.'paɪ.nɪŋ
unlovely	ʌn.'lʌv.li
lightsome	'laɪt.sʌ
mood—such	'mʉːd.'sʌtʃ
unbiassed	ʌn.'baɪ.ʌs
unbewildered	ʌn.bɪ.'wɪl.dʌ
unawed	ʌ.'nɔː
realised	'ɹeɪ.ʌ.laɪz
unsmitten	ʌn.'smɪ.tʌ
humbleness	'hʌm.bʌl.nʌ
unpeaceful	ʌn.'pi.sfʌ
tassels	'tæ.sʌl
uplooking	'ʌ.plʊə.kɪŋ
heedlessly	'hid.lʌ.slɪ
sympathy.—in	'sɪm.pʌ.θi.'ɪ
which—to	'wɪtʃ.tʉː
welterings	'wɛl.tʌ.ɹɪŋ
passion—is	'pæ.ʃʌ.nɪ
wretchedness	'ɹɛ.tʃɪd.nʌ
contentedness	kʌn.'tɛn.tɪd.nʌ
pilfered	'pɪl.fʌ
indolence	'ɪn.dʌ.lʌn
life—far	'laɪf.'fɑ
plea?—the	'pli.'ðʌ
streamlet	'stɹim.lʌ
dovedale's	'dʌv.deɪl
spiry	'spaɪ.ʌ.ɹɪ
me—such	`mi.'sʌtʃ
emont	ɪ.'mɑn
helvellyn	'hɛl.vɪ.`lɪ
inspired;—that	ɪn.'spaɪ.ʌd.'ðæ
window's	'wɪn.dəʊ
turret's	'tʌ.ɹɪt
gladness	'ɡlæd.nʌ
reverenced	'ɹɛv.ɹʌns
breezes,—melancholy	'bɹi.zɪz.'mɛ.lʌn.`kɑ.li
etesian	ɛ.'ti.zeɪ.ʌ
pupilage	'pjʉː.pɪ.lɪdʒ
schoolmen	'skʉːl.mɛ
unrelentingly	`ʌn.ɹɪ.'lɛn.tɪŋ.lɪ
battened	'bæ.tʌn
harboured	'hɑ.bʌ
sallying	'sæ.li.ɪŋ
omening	'əʊm.nɪŋ
undulations	`ʌnd.jʊə.'leɪ.ʃʌn
unhoused	ʌn.'haʊz
spousals	'spaʊ.sʌl
solemnised	'sɑ.lɪm.`naɪz
vapoured	'veɪ.pʌ
unruliness	ʌn.'ɹʉː.li.nʌ
landed—took	'læn.dɪd.'tʊə
hospitably	'hɑ.spɪ.tʌ.blɪ
chartreuse	ʃɑ.'tɹəː
ghostliness	'ɡəʊst.li.nʌ
hands!"—the	'hændz.'ðʌ
penitential	`pɛ.nɪ.'tɛn.ʃʌ
exchanged—to	ɛks.'tʃeɪndʒd.tʉː
equalise	'i.kwʌ.`laɪ
votaries	'vɑ.tʌ.ɹi
untransmuted	ʌn.tɹæns.'mjʉː.tɪ
cerulean	'sɛ.ɹʉː.`leɪ.ʌ
ether's	'i.θʌ
unapproachable	ʌ.næ.'pɹəʊ.tʃʌ.bʌ
cheeringly	'tʃeɪ.ʌ.ʌ.ɹɪŋ.lɪ
vallombre's	'væ.lɑm.bɹʌ
undiscriminating	ʌn.dɪ.'skɹɪ.mɪ.`neɪ.tɪŋ
mounted—from	'maʊn.tɪd.fɹɑ
unchastened	ʌn.'tʃeɪ.stʌn
unraised	ʌn.'ɹeɪz
sanctified	'sɑnk.tɪ.`faɪ
abodes	æ.'bəʊd
glistenings	'ɡlɪ.sʌ.nɪŋ
lorded	'lɔː.dɪ
chamouny	'tʃæ.maʊ.ni
pensively	'pɛn.sɪv.li
pleasure's	'plɛ.ʒʌ
posies	'pəʊ.zɪ
funereal	fjʉː.'neɪ.ʌ.ɹɪ.ʌ
vallais	'væ.leɪ
simplon's	'sɪm.plɑn
muleteers	`mjʊə.lɪ.'teɪ.ʌ.ʌ
stream's	'stɹim
torrent's	'tɑ.ɹʌnt
unbridged	ʌn.'bɹɪdʒ
peasant's	'pɛ.zʌnt
this,—that	'ðɪs.'ðæ
imagination—here	ɪ.`mæ.dʒɪ.'neɪ.ʃʌn.'heɪ.ʌ.ʌ
unfathered	ʌn.'fɑ.ðʌ
enwraps	ɛn.'ɹæp
harbours	'hɑ.bʌ
abyssinian	æ.bɪ.'sɪ.neɪ.ʌ
fertilise	'fəː.tʌ.`laɪ
6)the	'sɪks.ðʌ
deafened	'dɛ.fʌn
uprisen	'ʌ.pɹaɪ.sʌ
neighbours	'neɪ.bʌ
locarno's	ləʊ.'kɑ.nəʊ
locarno	ləʊ.'kɑ.nəʊ
cloistral	'klɔɪ.stɹʌ
ungreeted	ʌn.'ɡɹi.tɪ
submissiveness	sʌb.'mɪ.sɪv.nʌ
gravedona	ɡɹeɪv.'dəʊ.nʌ
como's	kʌ.'məʊ
sprinklings	'spɹɪŋ.klɪŋ
hyperboles	haɪ.'pəː.bʌ.`li
overborne	`əʊ.vʌ.'bɔː
forms—did	'fɔːmz.'dɪ
tenderness,—to	'tɛn.dʌ.nʌ.'stʉː
belovèd	bɪ.'lʌv
7	'sɛ.vʌ
fervour	'fəː.vʌ
scafell's	'skeɪ.fʌl
unabating	`ʌ.næ.'beɪ.tɪŋ
yester	'jɛ.stʌ
redbreasts	'ɹɛd.bɹɛst
threshold,—minstrels	'θɹɛ.ʃəʊld.'mɪn.stɹʌl
heartsome	'hɑt.sʌ
choristers	'kɔː.ɹɪ.stʌ
unscared	ʌn.'skəː
unwithered	ʌn.'wɪ.ðʌ
excursion,(8	ɛk.'skəː.ʃʌ.'neɪ
unenslaved	`ʌ.nɛn.'sleɪv
idler's	'aɪd.lʌ
whatsoe'er	'wɑt.səʊ.ʌ
tartarian	tɑ.'təː.ɹeɪ.ʌ
wilds—fell	'waɪldz.'fɛ
london—held	'lʌn.dʌn.'hɛl
childhood's	'tʃaɪld.hʊəd
cagèd	'keɪdʒ
parrot's	'pæ.ɹʌt
prompter's	'pɹɑmp.tʌ
recal	ɹɪ.'kæ
mitred	'mɪ.tɹʌ
wond'rous	'wʌn.dɹʌ
ranelagh	'ɹeɪn.lɑ
recumbent	ɹɪ.'kʌm.bʌn
statues—man	'stæ.tʃʉːz.'mæ
him—in	`hɪ.'mɪ
bestriding,—every	bɪ.'stɹaɪ.dɪŋ.'ɛv.ɹɪ
cased	'keɪs
prescriptive	pɹɪ.'skɹɪp.tɪ
blazoned	'bleɪ.zɑn
tradesman's	'tɹeɪdz.mʌn
allegoric	`æ.lɪ.'ɡɑ.ɹɪ
physiognomies	`fɪ.zɪ.'ɑɡ.nʌ.mɪ
shakspeare	'ʃæk.speɪ.ʌ.ʌ
raree	'ɹæ.ɹi
savoyards	'seɪ.vɔɪ.`ɑd
shrillest	'ʃɹɪ.lʌs
peradventure	`pɛ.ɹæd.'vɛn.tʃʌ
thrids	'θɹɪd
steadying	'stɛ.dɪ.ɪŋ
enough;—the	ɪ.'nʌf.'ðʌ
lascars	'læ.skɑ
doors,—birds	'dɔːz.'bəːd
haunt,—the	'hɔːnt.'ðʌ
sibyl's	'sɪ.bɪl
pantomimic	`pɑn.tʌ.'mɪ.mɪ
sadler's	'sæd.lʌ
conjurors	'kʌndʒ.jʊə.ɹʌ
harlequins	'hɑ.lɪ.`kwɪn
rabblement	'ɹæ.bʌl.mʌn
interlunar	`ɪn.tʌ.'lʉː.nʌ
ground,—the	'ɡɹaʊnd.'ðʌ
buttermere	'bʌ.tʌ.`meɪ.ʌ.ʌ
maiden's	'meɪ.dʌn
unfamiliarly	ʌn.fʌ.'mɪ.leɪ.ʌ.ʌ.li
her,—her	'həː.'həː
notice—an	'nəʊ.tɪ.sæ
commingled—shapes	kʌ.'mɪŋ.ɡʌld.'ʃeɪp
tread—thy	'tɹɛd.`ðaɪ
unsheltered	ʌn.'ʃɛl.tʌ
child!—these	'tʃaɪld.'ði
prattle—child	'pɹæ.tʌl.'tʃaɪl
lustres	'lʌ.stʌ
blown—a	'bləʊ.'neɪ
child—if	'tʃaɪl.dɪ
caressed	kʌ.'ɹɛs
unsinged	ʌn.'sɪndʒ
manacles	'mæ.nʌ.kʌl
pawed	'pɔː
smites	'smaɪt
prate	'pɹeɪ
whereabout	'wəː.ɹæ.`baʊ
way—that	'weɪ.'ðæ
eddying	'ɛ.dɪ.ɪŋ
gladdened	'ɡlæ.dʌn
promptness	'pɹɑmpt.nʌ
shakspeare's	'ʃæk.speɪ.ʌ.ʌ
professedly	pɹʌ.'fɛ.sɪd.lɪ
ermined	'əː.mɪn
bedfords	'bɛd.fʌd
glosters	'ɡlɑ.stʌ
salsburys	'sæls.bɹɪ
trifler	'tɹaɪ.flʌ
flighted	'flaɪ.tɪ
him,—old	'hɪ.'məʊl
forewarns	fɔː.'wɔːn
some—say	`sʌm.'seɪ
galled	'ɡɔːl
unthankful	ʌn.'θæŋk.fʌ
pulpit's	'pʌl.pɪt
admonishments	æd.'mɑ.nɪʃ.mʌnt
ossian	'ɑ.ʃʌ
streamy	'stɹi.mi
morven—each	'mɔː.vʌ.'nitʃ
conventicle	kʌn.'vɛn.tɪ.kʌ
singularity	`sɪŋ.ɡjʊə.'læ.ɹɪ.ti
bestrew	bɪ.'stɹʉː
father—for	'fɑ.ðʌ.fɔː
unmoving	ʌn.'mʉː.vɪŋ
faculties,—the	'fæ.kʌl.`tiz.'ðʌ
unfrequent	ʌn.'fɹi.kwʌn
unwholesome	ʌn.'həʊl.sʌ
astir	æ.'stəː
rejoicings	ɹɪ.'dʒɔɪ.sɪŋ
one,—that	'wɑn.'ðæ
muse's	'mjʉː.sɪ
showman's	'ʃəʊ.mʌn
infernal,—a	ɪn.'fəː.nʌ.'leɪ
phantasma	'fɑn.tæz.mʌ
roundabouts	'ɹaʊn.dæ.`baʊt
rivalship	'ɹaɪ.vʌl.`ʃɪ
buffoons	bʌ.'fʉːn
screaming,—him	'skɹi.mɪŋ.'hɪ
hurdy	'həː.di
gurdy	'ɡəː.di
timbrel	'tɪm.bɹʌ
equestrians	ɛ.'kwɛ.stɹeɪ.ʌn
breeched	'bɹitʃ
moveables	'mʉː.vʌ.bʌl
here—albinos	'heɪ.ʌ.ʌ.æl.'bi.nəʊ
ventriloquists	vɛn.'tɹɪ.lʌ.`kwɪst
goggling	'ɡɑ.ɡlɪŋ
promethean	'pɹəʊ.mi.`θeɪ.ʌ
comprehensiveness	`kɑm.pɹɪ.'hɛn.sɪv.nʌ
arab's	'æ.ɹʌb
clouds,—even	'klaʊd.'zi.vʌ
multitudinous	`mʌl.tɪt.'jʉː.dɪ.nʌ
ennobling	ɛ.'nəʊ.blɪŋ
retrospect.—love	`ɹɛ.tɹəʊ.'spɛkt.'lʌ
tillers	'tɪ.lʌ
ground—betimes	'ɡɹaʊnd.bɪ.'taɪm
fair—a	'fəː.'eɪ
unshrouded	ʌn.'ʃɹaʊ.dɪ
byre	'baɪ.ʌ
chaffering	'tʃæ.fʌ.ɹɪŋ
bleat	'bli
hawker's	'hɔː.kʌ
wares—books	'wəːz.'bʊək
mountebank	'maʊn.tɪ.`bæŋ
unbends	ʌn.'bɛnd
9	'naɪ
share.—immense	'ʃəː.ɪ.'mɛn
circumambient	'səː.kʌ.`mæm.beɪ.ʌn
glistens	'ɡlɪ.sʌn
gehol's	'dʒɛ.hɑl
dells	'dɛl
unwooed	ʌn.'wʉː
even—simplicity	'i.vʌn.sɪm.'plɪ.sɪ.ti
embosom	ɛm.'bɑ.sʌ
creature's	'kɹi.tʃʌ
kindliness	'kaɪnd.li.nʌ
latian	'leɪ.ʃʌ
fastnesses	'fɑst.nʌ.sɪ
phœbe	'fəʊ
florizel	'flɑ.ɹɪ.zʌ
unluxuriant	ʌn.'lʌɡʒ.jʊə.`ɹeɪ.ʌn
wanting,—the	'wɑn.tɪŋ.'ðʌ
everflowing	'ɛ.vʌ.`fləʊ.ɪŋ
galesus	'ɡeɪl.sʌ
adria's	'æ.dɹi.ʌ
clitumnus	'klaɪ.tʌm.nʌ
lucretilis	'lʉː.kɹɪ.`tɪ.li
tutelary	'tjʉː.tɪ.lʌ.ɹi
islanded	'aɪ.lʌn.dɪ
risings	'ɹaɪ.zɪŋ
unlaborious	ʌn.læ.'bɔː.ɹɪ.ʌ
beechen	'bi.tʃʌ
goslar	'ɡɑ.slʌ
northwards	'nɔː.θwʌd
hercynian	həː.'sɪ.neɪ.ʌ
headlands	'hɛd.lʌnd
enwrought	ɛn.'ɹɔː
protending	'pɹəʊ.tɛn.dɪŋ
fancy's	'fæn.si
creature—spiritual	'kɹi.tʃʌ.'spɪ.ɹɪ.`tʃʉː.ʌ
corin	'kɑ.ɹɪ
coronal	'kɑ.ɹɑ.nʌ
wheresoever	wəː.`səʊ.'ɛ.vʌ
howsoever	haʊ.`səʊ.'ɛ.vʌ
prepossession	pɹɪ.pʌ.'zɛ.ʃʌ
laughters	'lɑf.tʌ
contempts	kʌn.'tɛmpt
obeisances	'əʊ.bɪ.sʌn.sɪ
circumfuse	'səː.kʌm.`fjʉː
charnel	'tʃɑ.nʌ
ladder's	'læ.dʌ
turf's	'təːf
disenchant	`dɪ.sɛn.'tʃɑn
sickliness	'sɪ.kli.nʌ
once—while	'wɑn.'swaɪ
hill—thus	'hɪl.'ðʌ
10	'tɛ
colouring	'kʌ.ləː.ɹɪŋ
trembled,—thought	'tɹɛm.bʌld.'θɔː
ponder—judging	'pɑn.dʌ.'dʒʌ.dʒɪŋ
guidance—one	'ɡaɪ.dʌn.`swɑ
preceptress	pɹɪ.'sɛp.tɹʌ
thridded	'θɹɪ.dɪ
overpast	`əʊ.vʌ.'pɑs
antiparos	`æn.tɪ.'pæ.ɹəʊ
yordas	'jɔː.dʌ
unsettles	ʌn.'sɛ.tʌl
spectres,—ferment	'spɛk.tʌz.fəː.'mɛn
busies	'bɪ.zɪ
assembled,—here	æ.'sɛm.bʌld.'heɪ.ʌ.ʌ
landscape,—there	'lænd.skeɪp.'ðəː
apprehensiveness	`æ.pɹɪ.'hɛn.sɪv.nʌ
harmonising	'hɑ.mʌ.`naɪ.zɪŋ
impregnations	ɪm.`pɹɛɡ.'neɪ.ʃʌn
seclusions	sɪ.'klʉː.ʒʌn
uncongenial	ʌn.kʌn.'dʒi.nɪ.ʌ
feelingly	'fi.lɪŋ.lɪ
11	ɪ.'lɛ.vʌ
affectingly	æ.'fɛk.tɪŋ.lɪ
whencesoe'er	'wɛn.sɪ.`səʊ.ʌ
river,—partly	'ɹɪ.vʌ.'pɑt.li
engulph	ɛn.'ɡʌl
sojourning	'səʊ.dʒəː.nɪŋ
geneviève	'dʒɛ.nɪ.`vi
jacobins	'dʒæ.kʌ.`bɪn
haranguers	hæ.'ɹæŋ.ʌ
factionists	'fæk.ʃʌ.`nɪst
vexation	vɛk.'seɪ.ʃʌ
traveller's	'tɹæ.vʌ.lʌ
bedropped	'bɛ.dɹɑp
transmigrations	tɹæn.smɪ.'ɡɹeɪ.ʃʌn
punctilio	pʌŋk.'tɪ.lɪ.`əʊ
heedless	'hid.lʌ
commotions	kʌ.'məʊ.ʃʌn
locusts,—carra	'ləʊ.kʌst.'skæ.ɹʌ
gorcas,—add	'ɡɔː.kʌ.'zæ
historian's	hɪ.'stɔː.ɹeɪ.ʌn
crudest	'kɹʉː.dʌs
retaineth	ɹɪ.'teɪ.nʌθ
homeliness	'həʊm.li.nʌ
promptest	'pɹɑmp.tʌs
soldiership	'səʊl.dʒʌ.`ʃɪ
then,—but	'ðɛn.'bʌ
severings	'sɛ.vʌ.ɹɪŋ
martyr's	'mɑ.tʌ
indisposed	`ɪn.dɪ.'spəʊz
contemplations	`kɑn.tɪm.'pleɪ.ʃʌn
abideth	æ.'baɪ.dʌθ
imbecility	ɪm.bɪ.'sɪ.lɪ.ti
continence	'kɑn.tɪ.nʌn
rotha's	'ɹɑ.θʌ
devoted,—one	dɪ.'vəʊ.tɪ.'dwɑ
deliverer's	dɪ.'lɪ.vʌ.ɹʌ
task,—and	'tɑ.'skæn
eudemus	'jʉː.dɛ.mʌ
timonides	'tɪ.mʌ.`naɪd
zacynthus,—philosophic	'zæ.sɪn.θʌ.`sfɪ.lʌ.'sɑ.fɪ
beaupuis	'bəʊ.pjʉː.`i
accoutred	æ.'kʉː.tɹʌ
festal	'fɛ.stʌ
waveless	'weɪv.lʌ
unseen,—a	ʌn.'si.'neɪ
merriment	'mɛ.ɹɪ.mʌn
satyrs	'sæ.tʌ
colloquies	'kɑ.lʌ.`kwɪ
bewail	bɪ.'weɪ
romorentin	'ɹɑ.mʌ.`ɹɛn.tɪ
blois	'blɔɪ
chambord	'tʃeɪm.bɔː
chivalrous	'ʃɪ.vʌl.ɹʌ
heifer's	'hɛ.fʌ
benignant	bɪ.'nɪɡ.nʌn
unthwarted	ʌn.'θwɔː.tɪ
legalised	'li.ɡʌ.`laɪz
tale,(12	'teɪl.'twɛl
might—and	'maɪ.tæn
howe'er	'haʊ.əː
vaudracour	'vɔː.dɹæ.kʌ
viperous	'vaɪ.pʌ.ɹʌ
prayerless	'pɹəː.lʌ
wasted,—an	'weɪ.stɪ.'dæ
france.—(continued	'fɹɑn.skʌn.'tɪn.jʉː
it—on	ɪ.'tɑ
they—who	ðeɪ.'hʉː
rajahs	'ɹɑ.dʒɑ
omrahs	'ɑm.ɹʌ
moments—they	'məʊ.mʌnts.ðeɪ
upbraids	ʌp.'bɹeɪd
unextinguished	`ʌ.nɛk.'stɪŋ.ɡwɪʃ
bawling	'bɔː.lɪŋ
robespierre	'ɹəʊb.spɪ.`əː
hardihood	'hɑ.dɪ.`hʊə
louvet	'lʉː.vɪ
impiety—my	ɪm.'paɪ.ʌ.tɪ.'maɪ
throughly	'θɹʉː.li
discomfiture	dɪ.'skɑm.fɪ.tʃʌ
subsists	sʌb.'sɪst
revelation's	`ɹɛ.vɪ.'leɪ.ʃʌn
harmodius	hɑ.'məʊ.dɪ.ʌ
aristogiton	'æ.ɹɪ.`stɑ.dʒɪ.tʌ
brutus—that	'bɹʉː.tʌs.'ðæ
crests—have	'kɹɛsts.'hæ
lawgivers	'lɔː.ɡɪ.vʌ
it,—now	'ɪt.'naʊ
albion's	'æl.bɪ.ʌn
harebell	'həː.bɛ
rock—its	'ɹɑ.kɪt
place—so	'pleɪs.'səʊ
afterwards—truth	'ɑf.tʌ.wʌdz.'tɹʉːθ
o'erthrown	'ɔː.θɹəʊ
chaplet	'tʃæ.plʌ
convocation—there	kɑn.vʌ.'keɪ.ʃʌn.'ðəː
monitory	'mɑ.nɪ.tʌ.`ɹi
tranquillity	tɹæn.'kwɪ.lɪ.ti
intermeddlers	`ɪn.tʌ.'mɛd.lʌ
field—all	'fil.'dɔː
enormities	ɪ.'nɔː.mɪ.ti
woful	'wəʊ.fʌ
godhead's	'ɡɑd.hɛd
thoughts,—my	'θɔːt.'smaɪ
tribunals,—with	tɹaɪ.'bjʉː.nʌlz.'wɪð
refuge—my	'ɹɛ.fjʉːdʒ.'maɪ
ascents	æ.'sɛnt
sequestered—what	si.'kwɛ.stʌ.'dwɑ
desolated	'dɛ.sʌ.lʌ.tɪ
acquiescences	`æ.kwɪ.'ɛ.sʌn.sɪ
ungentle	ʌn.'dʒɛn.tʌ
scoffers	'skɑ.fʌ
eventide	ɪ.'vɛn.taɪ
reproached	ɹɪ.'pɹəʊtʃ
winds—i	'wɪnd.'zaɪ
quarrelled	'kwɑ.ɹʌl
leven's	'li.vʌn
consistory	kʌn.'sɪ.stʌ.`ɹi
seraphs	'sɛ.ɹʌf
enrapt	ɛn.'ɹæp
briny	'bɹaɪ.ni
romish	'ɹɑ.mɪʃ
dead!"—nor	'dɛd.'nɔː
augean	'ɔː.dʒeɪ.ʌ
tranquillised	'tɹæn.kwɪ.`laɪz
when—spurring	`wɛn.'spəː.ɹɪŋ
france.—(concluded	'fɹɑn.skʌn.'klʉː.dɪ
unambitious	ʌ.næm.'bɪ.ʃʌ
noiseless	'nɔɪz.lʌ
quality,—that	'kwɑ.lɪ.ti.'ðæ
nature,—hence	'neɪ.tʃʌ.'hɛn
interregnum's	`ɪn.tʌ.ɹɪɡ.'nʌm
stupified	'stjʉː.pɪ.`faɪ
newsman's	'njʉːz.mæn
thirsting	'θəː.stɪŋ
sanctuary's	'sɑnkt.jʉː.ʌ.`ɹi
given—to	'ɡɪ.vʌn.tʉː
needed—i	'ni.dɪ.'daɪ
13	'θəː.ti
auxiliars	'ɔːk.sɪ.`leɪ.ʌ.ʌ
enchantress—to	ɛn.'tʃɑn.tɹʌ.stʉː
promise—that	'pɹɑ.mɪs.'ðæ
subtilty	'sʌb.tɪl.ti
ministers,—who	'mɪ.nɪ.stʌz.'hʉː
it;—they	'ɪt.'ðeɪ
schemers	'ski.mʌ
utopia,—subterranean	jʉː.'təʊ.peɪ.ʌ.`sʌb.tɪ.'ɹeɪ.neɪ.ʌ
us,—the	'ʌs.'ðʌ
remoulds	ɹɪ.'məʊld
convoked	kʌn.'vəʊk
taught—antiquity	'tɔː.tæn.'tɪ.kwɪ.ti
all—for	'ɔːl.fɔː
sedulously	'sɛd.jʊə.lʌ.sli
understanding's	`ʌn.dʌ.'stæn.dɪŋ
object—evidence	'ɑb.dʒɛk.'tɛ.vɪ.dʌn
magisterially	`mæ.dʒɪ.'steɪ.ʌ.ɹɪ.ʌ.li
it;—but	'ɪt.'bʌ
true—could	'tɹʉː.'kʊə
aberrations—had	`æ.bʌ.'ɹeɪ.ʃʌnz.`hæ
anatomise	'æ.næ.tʌ.`maɪ
misguiding	mɪs.'ɡaɪ.dɪŋ
contrarieties	`kɑn.tɹʌ.'ɹi.tɪ
derived—find	dɪ.'ɹaɪvd.'faɪn
admonition—like	`æd.mʌ.'nɪ.ʃʌn.'laɪ
bedimmed	bɪ.'dɪm
sinkings	'sɪŋ.kɪŋ
clouds—his	'klaʊdz.'hɪ
glory's	'ɡlɔː.ɹi
gewgaw	'dʒjʉː.ɡɔː
timoleon	tɪ.'məʊ.lɪ.ʌ
prostrated	'pɹɑ.stɹeɪ.tɪ
requited	ɹɪ.'kwaɪ.tɪ
reanimating	ɹi.'æ.nɪ.`meɪ.tɪŋ
bestrewn	bɪ.'stɹʉː
sanative	'sæ.nʌ.`tɪ
reascend	'ɹi.sʌn
gladsomeness	'ɡlæd.sʌm.nʌ
tak'st	'tæks
etna's	'ɛt.nʌ
theocritus,(14	θi.ʌ.'kɹɪ.tʌ.'sfɔː.ti
reportest	ɹɪ.'pɔː.tʌs
comates	'kəʊ.meɪt
goatherd	'ɡəʊ.ðəː
arethuse	'æ.ɹɪ.`θjʉː
gratulatest	'ɡɹæ.tʃʊə.`leɪ.tʌs
pebbly	'pɛ.bli
heedeth	'hi.dʌθ
favoured—such	'feɪ.vʌd.'sʌtʃ
overpressure	`əʊ.vʌ.'pɹɛ.ʃʌ
gulph	'ɡʌl
creatures;—yet	'kɹi.tʃʌz.'jɛ
cowled	'kaʊl
unsoul	ʌn.'səʊ
syllogistic	`sɪ.lʌ.'dʒɪ.stɪ
countermarched	'kaʊn.tʌ.`mɑtʃ
remissness	ɹɪ.'mɪ.snʌ
inaptitude	ɪ.'næp.tɪt.`jʉː
unworthily	ʌn.'wəː.ðɪ.lɪ
more,—for	'mɔː.'fɔː
habit—giving	'hæ.bɪt.'ɡɪ.vɪŋ
abstruser	æb.'stɹʉː.sʌ
insatiably	ɪn.'seɪ.ʃæ.bli
counterturns	'kaʊn.tʌ.`təːn
thraldom	'θɹæl.dʌ
intermeddling	`ɪn.tʌ.'mɛd.lɪŋ
diviner	dɪ.'vɪ.nʌ
degradation—howsoe'er	dɪ.ɡɹæ.'deɪ.ʃʌn.'haʊ.səʊ.ʌ
minstrelsies	'mɪn.stɹɛl.sɪ
inaudible—was	ɪ.'nɔː.dʌ.bʌl.wɑ
master—outward	'mɑ.stʌ.'aʊ.twʌ
encourager	ɛn.'kʌ.ɹɪ.dʒʌ
mischance	mɪs.'tʃɑn
disjoined	dɪs.'dʒɔɪn
dismounting	dɪ.'smaʊn.tɪŋ
mouldered	'məʊl.dʌ
reascending	'ɹi.sʌn.dɪŋ
enshrining	ɛn.'ʃɹaɪ.nɪŋ
restoration.—yet	`ɹɛ.stʌ.'ɹeɪ.ʃʌn.'jɛ
palfreys	'pæl.fɹɪ
intermitting	`ɪn.tʌ.'mɪ.tɪŋ
time,—ere	'taɪ.'məː
sleety	'sli.ti
restored.—(concluded	ɹɪ.'stɔːd.kʌn.'klʉː.dɪ
incumbrances	ɪn.'kʌm.bɹʌn.sɪ
blazon—power	'bleɪ.zɑn.'paʊ.ʌ
purpose—early	'pəː.pʌ.'səː.lɪ
excellence—of	'ɛk.sʌ.lʌn.sɑ
thereon	ðəː.'ɹɑ
eyes—i	'aɪ.'zaɪ
continued.—for	kʌn.'tɪn.jʉːd.'fɔː
kindnesses	'kaɪnd.nʌ.sɪ
heaths	'hiθ
bedlamites	'bɛd.læ.`maɪt
and—now	ænd.'naʊ
effeminately	ɛ.'fɛ.mɪ.`neɪt.li
hope,—my	'həʊp.'maɪ
unexalted	`ʌ.nɛɡ.'zɑl.tɪ
therefrom	ðəː.'fɹɑ
oracular	ɔː.'ɹæ.kjʊə.lʌ
upholders	ʌp.'həʊl.dʌ
knoweth	'nəʊ.ʌθ
loveth	'lʌ.vʌθ
unregarded	`ʌn.ɹɪ.'ɡɑ.dɪ
intermingles	ɪn.'təː.mɪŋ.ɡʌl
animating	'æ.nɪ.`meɪ.tɪŋ
sarum's	'sɑ.ɹʌm
darkness—but	'dɑk.nʌs.`bʌ
men—how	'mɛn.'haʊ
judgment—and	'dʒʌdʒ.mʌn.tæn
world—a	'wəːl.'deɪ
bethgelert's	'bɛθ.dʒɛ.lʌt
couching	'kaʊ.tʃɪŋ
sallied	'sæ.li
breezeless	'bɹiz.lʌ
undiscouraged	ʌn.dɪ.'skʌ.ɹɪdʒ
lurcher	'ləː.tʃʌ
barkings	'bɑ.kɪŋ
earthward	'əː.θwʌ
broods	'bɹʉːd
moulded	'məʊl.dɪ
theirs—the	'ðəːz.ðʌ
hearts—if	'hɑt.sɪ
applied—that	æ.'plaɪd.'ðæ
passeth	'pɑ.sʌθ
yet—compassed	'jɛt.'kʌm.pʌs
declare—in	dɪ.'kləː.'ɪ
howsoe'er	'haʊ.səʊ.ʌ
rashly	'ɹæʃ.li
dust.—behold	'dʌst.bɪ.'həʊl
engulphed	ɛn.'ɡʌlf
dividually.—here	dɪ.'vɪ.dʒʉː.ʌ.li.'heɪ.ʌ.ʌ
keepest	'ki.pʌs
handmaid	'hænd.meɪ
interposition—a	`ɪn.tʌ.pʌ.'zɪ.ʃʌ.'neɪ
closelier	'kləʊ.slɪ.ʌ
presumptuously	pɹɪ.'sʌmp.tʃʉː.ʌ.sli
undomestic	ʌn.dʌ.'mɛ.stɪ
wanderer's	'wɑn.dʌ.ɹʌ
tarrying	'tæ.ɹɪ.ɪŋ
youth—(he	'jʉːθ.'hi
calvert—it	'kæl.vəː.tɪ
furthered—in	'fəː.ðʌ.'dɪ
attempered	æ.'tɛm.pʌ
gratulant	'ɡɹæt.jʊə.lʌn
quantock's	'kwɑn.tɑk
loitered	'lɔɪ.tʌ
bewitching	bɪ.'wɪ.tʃɪŋ
chaunt	'tʃɔːn
christabel	'kɹɪ.steɪ.bʌ
livelong	'laɪv.lɑŋ
solace—knowing	'sɑ.lɪ.'snəʊ.ɪŋ
unacquainted	ʌ.næ.'kweɪn.tɪ
tameness	'teɪm.nʌ
inspirit	'ɪn.spɪ.`ɹɪ
quiescence	kwɪ.'ɛ.sʌn
gallantly	'ɡæ.lʌnt.li
hemlocks	'hɛm.lɑk
eld	'ɛl
acadian	æ.'keɪ.deɪ.ʌ
pré	'pɹeɪ
acadie	æ.'keɪ.di
blomidon	'blɑ.mɪ.dʌ
fogs	'fɑɡ
henries	'hɛn.ɹɪ
kirtles	'kəː.tʌl
distaffs	dɪ.'stɑf
whir	'wəː
angelus	'æn.dʒɛ.lʌ
bellefontaine	'bɛ.lɪ.`fɑn.teɪ
stalworth	'stɔːl.wəːθ
flagons	'flæ.ɡɑn
kirtle	'kəː.tʌ
wreathing	'ɹi.ðɪŋ
wains	'weɪn
harrows	'hæ.ɹəʊ
seraglio	sʌ.'ɹæ.ɡlɪ.`əʊ
strutted	'stɹʌ.tɪ
selfsame	'sɛlf.seɪ
their's	'ðəː
sabring	'sæ.bɹɪŋ
linnet's	'lɪ.nɪt
silverly	'sɪl.vʌ.li
titmouse	'tɪt.maʊ
perfecter	pʌ.'fɛk.tʌ
whithersoever	`wɪ.ðʌ.`səʊ.'ɛ.vʌ
falser	'fɑl.sʌ
eustatio	jʉː.'steɪ.ʃɪ.`əʊ
especial	ɪ.'spɛ.ʃʌ
lateran	'læ.tʌ.ɹʌ
rubbishy	'ɹʌ.bɪ.ʃi
destructions	dɪ.'stɹʌk.ʃʌn
goths	'ɡɑθ
assujettissement	æ.'sʉː.dʒɪ.`tɪ.smʌn
trevellyn	tɹɪ.'vɛ.lɪ
superincumbent	`sʉː.pʌ.ɹɪn.'kʌm.bʌn
brickwork	'bɹɪ.kwəː
testaceo	'tɛ.steɪ.sɪ.`əʊ
bernini	bəː.'ni.nɪ
a.'s	'eɪ.'dɑt
mustachios	mʌ.'stæ.ʃɪ.`əʊ
abasements	æ.'beɪ.smʌnt
freiburg	'fɹeɪ.bəː
rheims	'ɹaɪm
recenter	'ɹi.sɛn.tʌ
gauds	'ɡɔːd
gewgaws	'dʒjʉː.ɡɔː
forsooth	fɔː.'sʉːθ
tranquilly	'tɹæn.kwɪ.`li
spray's	'spɹeɪ
dalmatic	dæl.'mæ.tɪ
slenderly	'slɛn.dʌ.li
cerements	'seɪ.ʌ.ʌ.mʌnt
scornfully	'skɔːn.fʌ.lɪ
mournfully	'mɔːn.fʌ.lɪ
undutiful	ʌnd.'jʉː.tɪ.fʌ
clammily	'klæ.mɪ.lɪ
sisterly	'sɪ.stʌ.li
casement	'keɪ.smʌn
houseless	'haʊ.slʌ
frigidly	'fɹɪ.dʒɪd.li
smoothe	'smʉːð
perishing	'pɛ.ɹɪ.ʃɪŋ
contumely	kʌnt.'jʉːm.li
trellises	'tɹɛ.laɪ.zɪ
wistlessness	'wɪst.lʌ.snʌ
prevaile	pɹɪ.'veɪ
doo't	'dʉː
selfe	'sɛl
shee	'ʃi
devill	dʌ.'vɪ
sieze	'si
pourest	'pɔː.ɹʌs
springest	'spɹɪŋ.ɡʌs
wingest	'wɪŋ.ɡʌs
singest	'sɪŋ.ɡʌs
unbodied	ʌn.'bɑ.dɪ
unbidden	ʌn.'bɪ.dʌ
unbeholden	ʌn.bɪ.'həʊl.dʌ
deflower'd	dɪ.'flaʊ.ʌ
wingéd	wɪŋ.'ɡeɪ
hymeneal	'haɪ.mʌ.`neɪ.ʌ
joyance	'dʒɔɪ.ʌn
scorner	'skɔː.nʌ
visiter	'vɪ.zɪ.tʌ
surcease	'səː.si
entreating	ɛn.'tɹi.tɪŋ
marvelled	'mɑ.vʌl
unmerciful	ʌn.'məː.sɪ.fʌ
dirges	'dəː.dʒɪ
cushion's	'kʊə.ʃʌn
lamplight	'læm.plaɪ
nepenthe	nɪ.'pɛn.θi
aidenn	'eɪ.dʌ
upstarting	'ʌp.stɑ.tɪŋ
wigwams	'wɪ.ɡwæm
ojibways	'ɑ.dʒɪb.`weɪ
dacotahs	'dæ.kɑ.tʌ
fen	'fɛ
shuh	'ʃʌ
gah	'ɡɑ
nawadaha	`næ.wʌ.'dɑ.hʌ
eyry	'aɪ.ɹi
chetowaik	'tʃɛ.təʊ.`eɪ
plover	'plʌ.vʌ
mahng	'mɑŋ
wawa	'wɑ.wʌ
mushkodasa	`mʌʃ.kəʊ.'dɑ.sʌ
tawasentha	tæ.'weɪ.sʌn.θʌ
alders	'ɔːl.dʌ
watersprings	'wɔː.tʌ.spɹɪŋ
paian	'peɪ.ʌ
pæans	'pɑn
galileans	'ɡæ.lɪ.`leɪ.ʌn
downsetting	'daʊn.sɪ.tɪŋ
godheads	'ɡɑd.hɛd
discrowned	dɪ.'skɹaʊn
disanointed	`dɪ.sæ.'nɔɪn.tɪ
songless	'sɑŋ.lʌ
coursers	'kɔː.sʌ
prancer	'pɹɑn.sʌ
donder	'dɑn.dʌ
blitzen	'blɪt.sʌ
twinkled	'twɪŋ.kʌl
dimples	'dɪm.pʌl
bowlfull	'bəʊl.fʊə
lances	'lɑn.sɪ
unlifted	ʌn.'lɪf.tɪ
unblown	ʌn.'bləʊ
baal	'bɑ
unsmote	ʌn.'sməʊ
snark	'snɑ
bonnets	'bɑ.nɪt
hyænas	haɪ.'ɑ.nʌ
impudent	ɪm.'pjʉː.dʌn
dunce	'dʌn
beaver's	'bi.vʌ
mercator's	məː.'keɪ.tʌ
equators	ɪ.'kweɪ.tʌ
joris	'dʒɔː.ɹɪ
dirck	'dəː
undrew	ʌn.'dɹʉː
postern	'pəʊ.stʌ
girths	'ɡəːθ
rebuckled	ɹɪ.'bʌ.kʌl
moonset	'mʉːn.sɛ
lokeren	'ləʊ.kɹʌ
düffeld	'dʉː.fɛl
mecheln	'mɛ.tʃɛl
aershot	'əː.ʃɑ
galloper	'ɡæ.ləʊ.pʌ
hasselt	'hæ.sɛl
fault's	'fɑlt
aix	'eɪk
haunches	'hɔːn.tʃɪ
looz	'lʉː
tongres	'tɑŋ.ɡʌ
dalhem	'dæl.hʌ
buffcoat	'bʌf.kəʊ
burgesses	'bəː.dʒɛ.sɪ
sombre	'sɑm.bʌ
midnights	'mɪd.naɪt
famishing	'fæ.mɪ.ʃɪŋ
morrows	'mɑ.ɹəʊ
despisest	dɪ.'spaɪ.sʌs
bedrape	bɪ.'dɹeɪ
libitina	`lɪ.bɪ.'ti.nʌ
priapus	'pɹaɪ.ʌ.pʌ
languors	'læŋ.ɡjʉː.ʌ
undreamt	ʌn.'dɹɛmp
ached	'eɪk
murm'ring	'məːm.ɹɪŋ
sol's	'sɑl
furze	'fəː
partridge's	'pɑ.tɹɪ.`dʒɪ
thrashers	'θɹæ.ʃʌ
rhime	'ɹaɪ
civiller	'sɪ.vɪ.lʌ
o'th	'əʊθ
misconstrues	mɪ.skʌn.'stɹʉː
politick	'pɑ.lɪ.`tɪ
stroker	'stɹəʊ.kʌ
backbiter	'bæk.bɪ.tʌ
scribler	'skɹɪ.blʌ
scurvy	'skəː.vi
dy	'daɪ
satyrical	sæ.'tɪ.ɹɪ.kʌ
ben't	'bɛn
wreathe	'ɹið
enlivens	ɛn.'laɪ.vʌn
falcon's	'fæl.kʌn
luve	'lʉː
melodie	mɛ.'ləʊ.di
bonie	'bəʊ.ni
wi	'waɪ
weel	'wi
visioned	'vɪ.ʒʌn
rest'st	'ɹɛsts
devotion's	dɪ.'vəʊ.ʃʌn
fervours	'fəː.vʌ
illume	ɪ.'lʉː
unconcern'dly	ʌn.kʌn.'səːnd.li
mixt	'mɪks
unlamented	ʌn.læ.'mɛn.tɪ
philosophique	fɪ.'lɑ.sʌ.'fi
debonnair	'dɛ.bʌ.`nəː
apparell'd	'æ.pʌ.ɹʌl
exactest	ɛɡ.'zæk.tʌs
passion's	'pæ.ʃʌn
utensil	jʉː.'tɛn.sʌ
housewifely	'haʊ.swaɪ.fli
chambermaid	'tʃeɪm.bʌ.`meɪ
malignity	mʌ.'lɪɡ.nɪ.ti
impell'd	ɪm.'pɛl
tardily	'tɑ.dɪ.lɪ
incurr'd	ɪn.'kəː
maidenheads	'meɪ.dʌn.`hɛd
shan't	'ʃɑn
unbelief	ʌn.bɪ.'li
breeches	'bɹi.tʃɪ
sattin	'sæ.tɪ
vermicular	vəː.'mɪ.kjʊə.lʌ
piony	pɪ.'ɑ.ni
lambkin	'læmb.kɪ
cripplegate	'kɹɪ.pʌl.`ɡeɪ
incommodiously	ɪn.kʌ.'məʊ.dɪ.ʌ.sli
settee	sɛ.'ti
brentford	'bɹɛnt.fʌ
recumbency	ɹɪ.'kʌm.bʌn.si
drawling	'dɹɔː.lɪŋ
snores	'snɔː
trunkless	'tɹʌŋ.klʌ
ozymandias	`ɑ.zɪ.'mɑn.deɪ.ʌ
wintering	'wɪn.tʌ.ɹɪŋ
dewdrop	'djʉː.dɹɑ
larkspur's	'lɑk.spʊə
rinsed	'ɹɪns
plushy	'plʌ.ʃi
unhouse	'ʌn.haʊ
7th	'sɛ.vʌnθ
1875	'wɑn.'θaʊ.zʌn.'deɪt.'hʌn.dɹʌ.dʌn.'sɛ.vʌn.ti.'faɪ
astrain	æ.'stɹeɪ
dovewinged	'dʌv.wɪndʒ
voel	'vəʊ
dappled	'dæ.pʌl
instressed	ɪn.'stɹɛs
christ,'s	'kɹaɪ.'stɛ
fondler	'fɑnd.lʌ
ercy	'əː.si
blear	'bleɪ.ʌ.ʌ
12	'twɛl
eastnortheast	'ist.nɔː.`θis
swivell	'swɪ.vɛ
unchilding	ʌn.'tʃaɪl.dɪŋ
unfathering	ʌn.'fɑ.ðʌ.ɹɪŋ
14	'fɔː.ti
kentish	'kɛn.tɪʃ
15	'fɪf.ti
trenched	'tɹɛntʃ
16	'sɪk.sti
rope's	'ɹəʊp
17	'sɛ.vʌn.`ti
18	'eɪ.ti
unteachably	ʌn.'ti.tʃʌ.blɪ
eldering	'ɛl.dʌ.ɹɪŋ
19	'naɪn.ti
sloggering	'slɑ.ɡʌ.ɹɪŋ
20	'twɛn.ti
coif	'kɔɪ
21	'twɛn.ti.'wɑ
gnashed	'næʃ
unchancelling	ʌn.'tʃɑn.sʌ.lɪŋ
poising	'pɔɪ.zɪŋ
leaved	'liv
astrew	æ.'stɹʉː
22	'twɛn.ti.'tʉː
bespoken	bɪ.'spəʊ.kʌ
priz	'pɹɪ
cinquefoil	'sɪn.kwɪ.`fɔɪ
ruddying	'ɹʌ.dɪ.ɪŋ
23	'twɛn.ti.'θɹi
gnarls	'nɑl
lovescape	'lʌv.skeɪ
leav	'li
24	'twɛn.ti.'fɔː
loveable	'lʌ.vʌ.bʌ
christens	'kɹɪ.stʌn
25	'twɛn.ti.'faɪ
gennesareth	'dʒɛ.nɪ.`sɑ.ɹʌθ
26	'twɛn.ti.'sɪk
belled	'bɛl
27	'twɛn.ti.'sɛ.vʌ
jading	'dʒeɪ.dɪŋ
tenderer	'tɛn.dʌ.ɹʌ
endragon	'ɛn.dɹæ.ɡʌ
28	'twɛn.ti.'eɪ
despatch	dɪ.'spætʃ
29	'twɛn.ti.'naɪ
unshapeable	ʌn.'ʃeɪ.pʌ.bʌ
tarpeian	'tɑ.peɪ.ʌ
30	'θəː.ti
jesu	'dʒɛ.sʉː
throe	'θɹəʊ
31	'θəː.ti.'wɑ
bitterer	'bɪ.tʌ.ɹʌ
unconfessed	ʌn.kʌn.'fɛs
uncomforted	ʌn.'kʌm.fʌ.tɪ
shipwrack	'ʃɪ.pɹæ
32	'θəː.ti.'tʉː
thce	`ti.`eɪtʃ.`si.'i
recurb	ɹɪ.'kəː
gulfs	'ɡʌlf
motionable	'məʊ.ʃʌ.nʌ.bʌ
33	'θəː.ti.'θɹi
outrides	aʊ.'tɹaɪd
plung	'plʌŋ
34	'θəː.ti.'fɔː
natur	'neɪ.tʃʌ
furled	'fəːl
35	'θəː.ti.'faɪ
dayspring	'deɪ.spɹɪŋ
cresseted	'kɹɛ.sɛ.tɪ
hearth's	'hɑθ
chivalry's	'tʃɪ.vʌl.ɹɪ
throng's	'θɹɑŋ
penmaen	'pɛn.mi
cadair	'kæ.dəː
dyphwys	'daɪf.wɪ
hummocked	'hʌ.mʌk
messmate	'mɛ.smeɪ
nobs	'nɑb
topsyturvy	'tɑp.sɪ.`təː.vi
mawddach	'mɔː.dætʃ
floodtide	'flʌd.taɪ
wattled	'wɑ.tʌl
roundels	'ɹaʊn.dʌl
weariest	'weɪ.ʌ.ʌ.ɹɪ.ʌs
furred	'fəː
braggart	'bɹæ.ɡɑ
bleared	'bleɪ.ʌ.ʌ
citadels	'sɪ.tʌ.`dɛl
quickgold	'kwɪk.ɡəʊl
whitebeam	'waɪt.bi
mealed	'mil
sallows	'sæ.ləʊ
withindoors	wɪ.'ðɪn.dɔː
thrush's	'θɹʌ.ʃɪ
peartree	'peɪ.ʌ.ʌ.tɹi
ents	'ɛnt
ellows	'ɛ.ləʊ
ensom	ɛn.'sɑ
fri	'fɹaɪ
crisps	'kɹɪsp
none's	'nʌn
daylight's	'deɪ.laɪt
dapple	'dæ.pʌ
fal	'fæ
wimpling	'wɪm.plɪŋ
ecstacy	'ɛk.stʌ.si
skate's	'skeɪt
eer	'eɪ.ʌ.ʌ
pl	`pi.'ɛ
sillion	'sɪ.leɪ.ʌ
stipple	'stɪ.pʌ
firecoal	'faɪ.ʌ.kəʊ
tr	`ti.'ɑ
adazzle	æ.'dæ.zʌ
stooks	'stʊək
wavier	'weɪ.vɪ.ʌ
ert	'əː
realer	'ɹeɪ.ʌ.lʌ
azurous	'æz.jʊə.ɹʌ
hurls	'həːl
uncumbered	ʌn.'kʌm.bʌ
enes	'in
esen	'ɛ.sʌ
eurydice	'jʉː.ɹɪ.dɪ
unawakened	ʌ.næ.'weɪ.kʌn
flockbells	'flɑk.bɛl
forefalls	'fɔː.fɔːl
freighted	'fɹeɪ.tɪ
bounden	'baʊn.dʌ
boldboys	'bəʊld.bɔɪ
biscay	'bɪ.skeɪ
lanced	'lɑns
beetling	'bit.lɪŋ
baldbright	'bɔːld.bɹaɪ
hailropes	'heɪl.ɹəʊp
heavengravel	'hɛ.vʌŋ.`ɡɹæ.vʌ
wolfsnow	'wʊəlf.snəʊ
overvaults	`əʊ.vʌ.'vɑlt
appledurcombe	'æ.pʌl.`dəː.kʉː
ventnor	'vɛnt.nʌ
boniface	'bɑ.nɪ.`feɪ
portholes	'pɔːt.həʊl
cheer's	'tʃeɪ.ʌ.ʌ
swerver	'swəː.vʌ
afterdraught	'ɑf.tʌ.`dɹɑf
wrings	'ɹɪŋ
deathgush	'dɛθ.ɡʌʃ
lifebelt	'laɪf.bɛl
rivelling	'ɹɪ.vʌ.lɪŋ
seamanship	'si.mʌn.`ʃɪ
sinew	'sɪn.jʉː
robbery's	'ɹɑ.bʌ.ɹi
wildworth	'waɪl.dwəːθ
daredeaths	'dəː.dɛθ
unchrist	ʌn.'kɹaɪs
riving	'ɹaɪ.vɪŋ
walsingham	'wɑl.sɪŋ.ʌ
savest	'seɪ.vʌs
doomfire	'dʉːm.faɪ.ʌ
candlemas	'kæn.dʌl.mʌ
opportunest	ɑ.pʌt.'jʉː.nʌs
throstle	'θɹɑ.sʌ
sympathising	'sɪm.pʌ.`θaɪ.zɪŋ
azuring	'æ.ʒʌ.ɹɪŋ
greybell	'ɡɹeɪ.bɛ
cuckoocall	'kʌ.kʉː.`kɔː
sandalled	'sæn.dʌl
enselve	ɛn.'sɛl
branchy	'bɹɑn.tʃi
pois	'pwɑ
brickish	'bɹɪ.kɪʃ
unraveller	ʌn.'ɹæ.vʌ.lʌ
rivalled	'ɹaɪ.vʌl
nursle	'nəː.sʌ
forg	'fɔː
moonmarks	'mʉːn.mɑk
stormfowl	'stɔːm.faʊ
wooddove	'wʊə.dʌ
peac	'pi
reaving	'ɹi.vɪŋ
bugler's	'bjʉː.ɡlʌ
bugler	'bjʉː.ɡlʌ
sendings	'sɛn.dɪŋ
tauntless	'tɔːnt.lʌ
mansex	'mæn.sɛk
forefending	'fɔː.fʌn.dɪŋ
dexterous	'dɛk.stʌ.ɹʌ
ees	'i
eys	'aɪ
efter	'ɛf.tʌ
soldiery	'səʊl.dɪ.ʌ.ɹi
bloomfall	'blʉːm.fɔː
sweet's	'swit
eigns	'eɪn
quickenings	'kwɪ.kʌ.nɪŋ
div	'dɪ
ene	'i
ch	`si.'eɪtʃ
ennelled	ɛ.'nɛl
backwheels	'bæ.kwil
wimpled	'wɪm.pʌl
ripest	'ɹaɪ.pʌs
injury's	'ɪn.dʒʌ.ɹi
morselled	'mɔː.sʌl
gorgon's	'ɡɔː.ɡʌn
barebill	'bəː.bɪ
yellowy	'jɛ.ləʊ.i
trambeams	'tɹæm.bim
truckle	'tɹʌ.kʌ
eagerer	'i.ɡʌ.ɹʌ
aggr	'æ.ɡʌ
endise	'ɛn.daɪ
spendsavour	'spɛnd.seɪ.vʌ
mannerly	'mæ.nʌ.li
lissome	'lɪz.sʌ
scions	sɪ.'ɑn
eep	'i
eeper	'i.pʌ
eals	'il
eumph	'jʉːm
heavenlier	'hɛ.vʌn.li.ʌ
endears	ɛn.'deɪ.ʌ.ʌ
fettle	'fɛ.tʌ
drayhorse	'dɹeɪ.hɔː
shrovetide	'ʃɹəʊv.taɪ
ehn	'eɪ
meanwhiles	'min.waɪl
byplay	'baɪ.pleɪ
imp's	'ɪmp
br	`bi.'ɑ
roguish	'ɹɑ.ɡwɪʃ
40	'fɔː.ti
ergar	'i.'ɑ.'ɡɑ
gr	`dʒi.'ɑ
eeving	'i.vɪŋ
goldengrove	'ɡəʊl.dʌŋ.`ɡɹəʊ
unleaving	ʌn.'li.vɪŋ
wanwood	'wæn.wʊə
leafmeal	'lif.meɪ.ʌ
errow's	'ɛ.ɹəʊ
spr	`ɛ.`spi.'ɑ
engs	'ɛŋ
earthless	'əːθ.lʌ
attuneable	æt.'jʉː.nʌ.bʌ
vaulty	'vɑl.ti
eme's	ɪ.'mɛ
hornlight	'hɔːn.laɪ
hoarlight	'hɔː.laɪ
overbend	`əʊ.vʌ.'bɛn
eaturing	'i.tʃʌ.ɹɪŋ
aswarm	æ.'swɔː
throughther	'θɹʉː.ðʌ
pashed	'pæʃ
eite	'aɪ
disremembering	`dɪs.ɹɪ.'mɛm.bʌ.ɹɪŋ
esmembering	ɛ.'smɛm.bʌ.ɹɪŋ
eur	'jʊə
wh	`dʌ.bʌl.`jʉː.'eɪtʃ
dragonish	'dɹæ.ɡʌ.nɪʃ
ened	'ɛn
sk	`ɛ.'skeɪ
eined	'aɪn
var	'vɑ
eety	'i.ti
tw	`ti.'dʌ.bʌl.`jʉː
spools	'spʉːl
ese	'i
erld	'əːl
selfwrung	'sɛl.fɹʌŋ
selfstrung	'sɛlf.stɹʌŋ
shelterless	'ʃɛl.tʌ.lʌ
eughts	'jʉːt
enst	'ɛns
rollrock	'ɹəʊl.ɹɑ
highroad	'haɪ.ɹəʊ
windpuff	'wɪnd.pʌ
eawn	'iw
fr	`ɛ.'fɑ
eth	'ɛθ
twindles	'twɪn.dʌl
pitchblack	'pɪtʃ.blæ
ewning	'jʉː.nɪŋ
degged	dɪ.'ɡɛ
braes	'bɹi
heathpacks	'hiθ.pæk
flitches	'flɪ.tʃɪ
beadbonny	'bid.bʌ.`ni
dragonflies	'dɹæ.ɡʌn.`flaɪ
ew	'jʉː
fl	`ɛ.'fɛ
eme	ɪ.'mɛ
eeps	'ip
chr	`si.`eɪ.'tʃɑ
louch	'laʊtʃ
selfbent	'sɛlf.bʌn
eny	ɛ.'naɪ
ece	'ɛ
ewn	'jʉː
singeing	'sɪn.dʒɪŋ
tingeing	'tɪn.dʒɪŋ
tenderest	'tɛn.dʌ.ɹʌs
lastingness	'lɑ.stɪŋ.nʌ
lovelocks	'lʌv.lɑk
gaygear	'ɡeɪ.ɡeɪ.ʌ.ʌ
girlgrace	'ɡəːl.ɡɹeɪ
eghs	'ɛɡ
lighthanded	'laɪt.hæn.dɪ
heavyheaded	'hɛ.vi.`hɛ.dɪ
hundredfold	'hʌn.dɹɪd.`fəʊl
fagged	'fæɡ
fashed	'fæʃ
cogged	'kɑɡ
cumbered	'kʌm.bʌ
erfeit	'əː.fɪ
girdles	'ɡəː.dʌl
fleeciest	'fli.sɪ.ʌs
frailest	'fɹeɪ.lʌs
flixed	'flɪks
goddess's	'ɡɑ.dɛ.sɪ
almoner	'ɑl.mʌ.nʌ
50	'fɪf.ti
deathdance	'dɛθ.dʌn
nazareths	'næ.zæ.ɹʌθ
60	'sɪk.sti
bethlems	'bɛθ.lʌm
bethlem	'bɛθ.lʌ
70	'sɛ.vʌn.`ti
azur	'æ.zəː
skywards	'skaɪ.wʌd
fingergaps	'fɪŋ.ɡʌ.`ɡæp
80	'eɪ.ti
90	'naɪn.ti
slake	'sleɪ
100	'wɑn.'hʌn.dɹʌ
vasty	'vɑ.sti
daystar	'deɪ.stɑ
110	'wɑn.'hʌn.dɹʌ.dʌn.'tɛ
scarless	'skɑ.lʌ
120	'wɑn.'hʌn.dɹʌ.dʌn.'twɛn.ti
isled	'ɪ.sʌl
danc	'dɑn
tars	'tɑ
makesbelieve	'meɪks.bɪ.`li
feigns	'feɪn
dears	'deɪ.ʌ.ʌ
bides	'baɪd
eeing	'i.ɪŋ
somewh	'sʌm
untwist	ʌn.'twɪs
lionlimb	'laɪ.ʌn.lɪ
bruis	'bɹʉː.i
eot	'i.ɑ
forepangs	'fɔː.pæŋ
ering	'əː.ɹɪŋ
fathomed	'fæ.ðʌm
garlanded	'ɡɑ.lʌn.dɪ
fallowbootfellow	'fæ.ləʊ.`bʉːt.fɪ.`ləʊ
rockfire	'ɹɑk.faɪ.ʌ
homeforth	'həʊm.fɔːθ
navvy	'næ.vi
seldomer	'sɛl.dʌ.mʌ
heartsore	'hɑt.sɔː
prickproof	'pɹɪk.pɹʉː
lacklevel	'læ.klɛ.vʌ
mammocks	'mæ.mʌk
mainstrength	'meɪn.stɹɛŋθ
undenizened	`ʌn.'dɛ.nɪ.zʌn
hangdog	'hæŋ.dɑ
manwolf	'mæn.wʊəl
goldish	'ɡəʊl.dɪʃ
barrelled	'bæ.ɹʌl
limb's	'lɪm
barrowy	'bæ.ɹəʊ.i
onewhere	'wɑn.wəː
curded	'kəː.dɪ
beechbole	'bitʃ.bəʊ
crimsons	'kɹɪm.sʌn
crossbridle	'kɹɑs.bɹaɪ.dʌ
windlaced	'wɪnd.leɪs
lilylocks	'lɪ.lɪ.`lɑk
churlsgrace	'tʃəːls.ɡɹeɪ
amansstrength	'æ.mæn.`stɹɛŋθ
cragiron	'kɹæ.dʒaɪ.ʌ
furls	'fəːl
fountain's	'faʊn.tɪn
erd	'əː
selfyeast	'sɛl.fɪ.`is
distils	dɪ.'stɪl
thirst's	'θəːst
jackself	dʒæk.'sɛl
betweenpie	bɪ.'twin.paɪ
puffball	'pʌf.bɔː
roysterers	'ɹɔɪ.stʌ.ɹʌ
roughcast	'ɹʌf.kɑs
shivelights	'ʃɪ.vɪ.`laɪt
shadowtackle	'ʃæ.dəʊ.`tæ.kʌ
yestertempest's	'jɛ.stʌ.`tɛm.pʌst
parches	'pɑ.tʃɪ
stanches	'stɑn.tʃɪ
manmarks	'mæn.mɑk
treadmire	'tɹɛd.maɪ.ʌ
footfretted	'fʊət.fɹɪ.tɪ
bonniest	'bɑ.nɪ.ʌs
selv	'sɛl
firedint	'faɪ.ʌ.dɪn
indig	ɪn.'dɪ
manshape	'mæn.ʃeɪ
disseveral	dɪ.'sɛ.vʌ.ɹʌ
resur	ɹɪ.'səː
rection	'ɹɛk.ʃʌ
residuary	ɹɪ.'sɪd.jʉː.ʌ.`ɹi
potsherd	'pɑ.tʃəː
matchwood	'mætʃ.wʊə
steeled	'stil
majorca	mæ.'dʒɔː.kʌ
sots	'sɑt
fretty	'fɹɛ.ti
chervil	'tʃəː.vʌ
eunuch	'jʉː.nʌtʃ
blowpipe	'bləʊ.paɪ
ascrib	æ.'skɹɪ
ersonal	'əː.sɑ.nʌ
ewed	'jʉː
ellow	'ɛ.ləʊ
bl	`bi.'ɛ
estering	'ɛ.stʌ.ɹɪŋ
surfy	'səː.fɪ
enderneath	'ɛn.dʌ.`niθ
jaunting	'dʒɔːn.tɪŋ
tramplers	'tɹɑm.plʌ
bluebells	'blʉː.bɛl
veriest	'veɪ.ʌ.ɹɪ.ʌs
aftercast	'ɑf.tʌ.`kɑs
fleeted	'fli.tɪ
dissolv	dɪ.'sɑl
ringlet	'ɹɪŋ.ɡlʌ
seamark	'si.mɑ
wav	'wæ
foredrawn	'fɔː.dɹɔː
heavenward	'hɛ.vʌn.wʌ
ashboughs	'æʃ.baʊ
clammyish	'klæ.mɪ.ɪʃ
lashtender	'læʃ.tɛn.dʌ
tabour	'tæ.bʌ
smouldering	'sməʊl.dʌ.ɹɪŋ
mells	'mɛl
snowwhite	'snəʊ.waɪ
gropes	'ɡɹəʊp
darkles	'dɑ.kʌl
gainings	'ɡeɪ.nɪŋ
betweenwhiles	bɪ.'twin.waɪl
53	'fɪf.ti.'θɹi
winefred's	'waɪn.fɹʌd
sc	`ɛs.'si
caerwys	kəː.'waɪ
beuno	'bjʉː.nəʊ
panion	'pæ.neɪ.ʌ
dirvan	'dəː.væ
gwenvrewi	'ɡwɛnv.ɹʉː.`i
dearness	'deɪ.ʌ.ʌ.nʌ
teryth	'təː.ɹɪθ
caradoc's	'kæ.ɹæ.`dɑk
ereas	ɪ.'ɹeɪ.ʌ
makebelieve	'meɪk.bɪ.`li
vengeances	'vɛn.dʒʌn.sɪ
purpling	'pəː.plɪŋ
lionlike	'laɪ.ʌn.laɪ
wrathful	'ɹæθ.fʌ
caradoc	'kæ.ɹæ.`dɑ
despatches	dɪ.'spæ.tʃɪ
emfort	ɛm.'fɔː
fleec	'fli
selfdisposal	`sɛlf.dɪ.'spəʊ.zʌ
een	'i
rushy	'ɹʌ.ʃi
lipmusic	lɪp.'mjʉː.zɪ
fallers	'fɔː.lʌ
frothpits	'fɹɑθ.pɪt
waterfearers	'wɔː.tʌ.`feɪ.ʌ.ʌ.ɹʌ
dene	'di
uproll	'ʌ.pɹəʊ
downcarol	'daʊn.kʌ.`ɹɑ
wr	`dʌ.bʌl.`jʉː.'ɑ
etten	'ɛ.tʌ
elmy	'ɛl.mi
elgrims	'ɛl.ɡɹɪm
roseleaves	'ɹəʊz.liv
boons	'bʉːn
fame's	'feɪm
commonweal	'kɑ.mʌn.`weɪ.ʌ
egdalen	'ɛɡ.deɪ.lʌ
fineflower	'faɪn.flaʊ.ʌ
goldnails	'ɡəʊld.neɪl
gaylinks	'ɡeɪ.lɪŋk
timber'll	'tɪm.bʌ.ɹʌ
enking	'ɛŋ.kɪŋ
ell's	'ɛl
butt's	'bʌt
furl	'fəː
dogrose	'dɑ.ɡɹəʊ
swarthed	'swɔːθ
fall'n	'fɔːl
sheaved	'ʃiv
fleeces	'fli.sɪ
sidled	'saɪ.dʌl
dewdrops	'djʉː.dɹɑp
enlight	ɛn.'laɪ
woodlark	'wʊəd.lɑ
eetop	'i.tɑ
ery	ʌ.'ɹi
enk	'ɛŋ
aflash	æ.'flæʃ
rudred	'ɹʌ.dɹʌ
sunspurge	'sʌn.spəːdʒ
oxeye	'ɑk.saɪ
fumitory	'fjʉː.mɪ.tʌ.`ɹi
nest's	'nɛst
paradisa	'pæ.ɹʌ.`dɪ.sʌ
ecal	'ɛ.kʌ
lustreless	'lʌ.stʌ.lʌ
maenefa	'mi.nɛ.fʌ
fanged	'fæŋ
sented	'sɛn.tɪ
transcriber's	tɹæn.'skɹaɪ.bʌ
majestical	mæ.'dʒɛ.stɪ.kʌ
groundlong	'ɡɹaʊnd.lɑŋ
viol	'vaɪ.ʌ
masque	'mæs
comfort's	'kʌm.fʌt
woe's	'wəʊ
cheerless	'tʃeɪ.ʌ.ʌ.lʌ
heltering	'hɛl.tʌ.ɹɪŋ
leafwhelmed	'lif.wɛlm
bushybowered	'bʊə.ʃɪ.`baʊ.ʌ
candycoloured	'kæn.dɪ.`kʌ.lʌ
gluegold	'ɡlʉː.ɡəʊl
blowballs	'bləʊ.bɔːl
honeysuck	'hʌ.nɪ.`sʌ
dogeared	'dəʊ.dʒəː
hazels	'heɪ.zʌl
downdolphinry	'daʊn.dʌl.`fɪn.ɹi
bellbright	'bɛl.bɹaɪ
dling	'di.'lɪŋ
earthworld	'əː.θwəːl
airworld	'əː.wəːl
shadowiest	'ʃæ.dəʊ.ɪ.ʌs
scrolled	'skɹəʊl
wychelm	'wɪ.tʃɛl
hornbeam	'hɔːn.bi
overstood	`əʊ.vʌ.'stʊə
hawkmoth	'hɔːk.mɑθ
woolwoven	'wʊəl.wəʊ.vʌ
twiny	'twaɪ.ni
offwrings	'ɑ.fʊə.ɹɪŋ
chancequarri	'tʃɑn.sɪ.`kwɑ.ɹi
selfquain	'sɛlf.kweɪ
warbles	'wɔː.bʌl
quicksilvery	'kwɪk.sɪl.vʌ.ɹi
shiv	'ʃɪ
heavenfallen	'hɛ.vʌn.`fɔː.lʌ
brims	'bɹɪm
kindcold	'kaɪnd.kəʊl
froliclavish	'fɹɑ.lɪ.`klæ.vɪʃ
wronging	'ɹɑŋ.ɪŋ
gambolling	'ɡæm.bɑ.lɪŋ
allboundedparses	'ɔːl.'baʊn.dɪd.'pɑ.sɪ
boundedparses	'baʊn.dɪd.'pɑ.sɪ
def	'dɛ
ngram(l,n=3	'ɛn.'ɡɹæ.'mɛ.'lɛ.'ni.kwʌlz.'θɹi
gram.append(x	'ɡɹæm.'dɑ.tæ.'pɛn.'dɛk
len(gram)<n	'lɛn.'ɡɹæ.'mɛ
g=tuple(gram	'dʒi.'i.kwʌlz.'tʉː.pʌl.'ɡɹæ
grams.append(g	'ɡɹæmz.'dɑ.tæ.'pɛnd.'dʒi
gram.reverse	'ɡɹæm.'dɑ.tɹɪ.'vəː
gram.pop	'ɡɹæm.'dɑt.'pɑ
gramstempestuous	`ɡɹæm.stɪm.'pɛs.tʃʉː.ʌ
e/scan	'i.'slæʃ.'skæ
